"a" = (/turf,/area)
"b" = (/mob/Eagle,/turf,/area)
"c" = (/obj/Collectible/Emerald,/turf,/area)
"d" = (/obj/Brick,/turf,/area)
"e" = (/obj/GooBlock,/turf,/area)
"f" = (/obj/Sparkle,/turf,/area)
"g" = (/obj/Checkpoint,/turf,/area)
"h" = (/mob/FlierHorizontal{step_x = 17},/turf,/area)
"i" = (/obj/Hazard/Spikes{tag = "icon-Spikes"; icon_state = "Spikes"; dir = 2},/turf,/area)
"j" = (/obj/Hazard/Spikes{tag = "icon-Spikes (EAST)"; icon_state = "Spikes"; dir = 4},/turf,/area)
"k" = (/mob/FlierVertical,/turf,/area)
"l" = (/obj/Hazard/Spikes{tag = "icon-Spikes (WEST)"; icon_state = "Spikes"; dir = 8},/turf,/area)
"m" = (/obj/Hazard/Spikes/Acidblock,/turf,/area)
"n" = (/obj/PlayerStart,/turf,/area)
"o" = (/obj/Platform,/turf,/area)
"p" = (/obj/Platform,/mob/Crawler,/turf,/area)
"q" = (/obj/Water/Surface,/turf,/area)
"r" = (/obj/Water,/turf,/area)
"s" = (/obj/Water,/obj/Collectible/Emerald,/turf,/area)
"t" = (/obj/SwitchBlock,/turf,/area)
"u" = (/obj/ToggleBlock,/turf,/area)
"v" = (/obj/ToggleBlock{tag = "icon-On"; icon_state = "On"},/turf,/area)
"w" = (/obj/Hazard/Spikes,/turf,/area)

(1,1,1) = {"
aaaaaaaaaaaaaaaaaaaaaaaaaaaaaaaaaaaaaaaaaaaaaaaaaaaaaaaaaaaa
aaaaaaaaaaaaaaaaaaaaaaaaaaaaaaaaaaaaaaaaaaaaaaaaaaaaaaaaaaaa
aaaaaaaaaaaaaaaaaaaaaaaaaaaaaaaaaaaaaaaaaaaaaaaaaaaaaaaaaaaa
aaaaaaaaaaaaaaaaaaaaaaaaaaaaaaaaaaaaaaaaaaaaaaaaaaaaaaaaaaaa
aaaaaaaaaaaaaaaaaaaaaaaaaaaaaaaaaaaaaaaaaaaaaaaaaaaaaaaaaaaa
aaaaaaaaaaaaaaaaaaaaaaaaaaaaaabaaaaaaaaaaaaaaaaaaaaaaaaaaaaa
aaaaaaaaaaaaaaaaaaaaaaaaaaaacaaaaaaaaaaaaaaaaaaaaaaaaaaaaaaa
aaaaaaaaaaaaaaaaaaaaaaaaaaaaaaaaaaaaaaaaaaaaaaaaaaaaaaaaaaaa
aaaaaaaaaaaaaaaaaaadddaeaeadddaaaaaaaaaaaaaaaaaaaaaaaaaaaaaa
aaaaaaaaaaaaaaaaaaaaaaaaaaaaaaaaaaaaaaaaaaaaaaaaaaaaaaaaaaaa
aaaaaaaaaaaaaaaaaaaaaaaaaaaaaaaaddfdaaaaaaaaaaaaaaaaaaaaaaaa
aaaaaaaaaaaaacaaaaaaaccaaaaaaaaaaafaaaaaaacdaaaaaaaaaaaaaaaa
aaaaaaaaaaaaaaaaaaaaaagahaaaaaaaaaaaaaaaaaddaaaaaaaaaaaaaaaa
aaaaaaaaaaaadddaaaaaiiiiaaaaaaaaiiiiaaaaadddaaaaaaaaaaaaaaaa
aaaaaaaaaaaadddfaaaaacaaacaaaacaaacaaaaafddaaaaaaaaaaaaaaaaa
aaaaaaaaaaaadjaaaacaaaaaaaaaaaaaaaaaacakaalaaaaaaaaaaaaaaaaa
mmmmmmmmmmmmdjaaaaaaaaaaaanaaaaaaaaaaaaaaalaaaaaaaaaaaaaaaaa
daaaaaaaadddddddddddaaaadddoodddaafadddddddaaaaaaaaaaaaaaaaa
daaacaadaaaaaaaaaaaaaaaaaaaooaaaaaaaaaaaaaaaaaaaaaaaaaaaaaaa
daaaaafdaccccgaaaaaaaadaacaopacaadqqqqqqqdiaaaaaaaaaaaaaaaaa
dacaaaadddddddaaaaaaafdmmmmmmmmmmdrrrrrrrdaaaaaaaaaaaaaaaaaa
daafaaaaaaaaadaaaaaaaadaaaaaaaaaadrsrrrsrdaaaaaaaaaaaaaaaaaa
daaaaaaaadddddaaaaaaaadaaaadqdddddrrrsrrrdaaaaaaaaaaaaaaaaaa
dcaafaaaaaaaaaaaaaaaaadaaaadrrrrrrrrrrrrrdaaaaaaaaaaaaaaaaaa
dfaaaacaadddaaaaaaaaafdaaafdddddddddddddddaaaaaaaaaaaaaaaaaa
daaaaaaaaaadfaaaaaaaaadfaaadataataaaaaaaaaaaaaaaaaaaaaaaaaaa
daafaaafaaadddaagaaaaadaadddaaaaaaaaaaaaaaaaaaaaaaaaaaaaaaaa
daaaaaaaaaadaddddddddddaaaaaaaaaaaaaaaaaaaaaaaaaaaaaaaaaaaaa
dmmmmmmmmmmdaaaaauuuuudddddvvauuavvadddddaaaaaaaaaaaaaaaaaaa
aaaaaaaaaaaaaaaaaaaaaaaaaaaaaaaaaaaaaaaaaaaaaaaaaaaaaaaaaaaa
aaaaaaaaaaaaaaaaaaaaaaaaaaaaaaaaaaaaaaaaaaaaaaaaaaaaaaaaaaaa
aaaaaaaaaaaaaaaaaaaaaaaaaaaaaaaaaaaaaaaaaaaaaaaaaaaaaaaaaaaa
aaaaaaaaaaaaaaaaaaaaaaaaaaaaaaaaaaaaaaaaaaaaaaaaaaaaaaaaaaaa
aaaaaaaaaaaaaaaaaaaaaaaaaaaaaaaaaaaaaaaaaaaaaaaaaaaaaaaaaaaa
aaaaaaaaaaaaaaaaaaaaaaaaaaaaaaaaaaaaaaaaaaaaaaaaaaaaaaaaaaaa
aaaaaaaaaaaaaaaaaaaaaaaaaaaaaaaaaaaaaaaaaaaaaaaaaaaaaaaaaaaa
aaaaaaaaaaaaaaaaaaaaaaaaaaaaaaaaaaaaaaaaaaaaaaaaaaaaaaaaaaaa
aaaaaaaaaaaaaaaaaaaaaaaaaaaaaaaaaaaaaaaaaaaaaaaaaaaaaaaaaaaa
aaaaaaaaaaaaaaaaaaaaaaaaaaaaaaaaaaaaaaaaaaaaaaaaaaaaaaaaaaaa
aaaaaaaaaaaaaaaaaaaaaaaaaaaaaaaaaaaaaaaaaaaaaaaaaaaaaaaaaaaa
aaaaaaaaaaaaaaaaaaaaaaaaaaaaaaaaaaaaaaaaaaaaaaaaaaaaaaaaaaaa
aaaaaaaaaaaaaaaaaaaaaaaaaaaaaaaaaaaaaaaaaaaaaaaaaaaaaaaaaaaa
aaaaaaaaaaaaaaaaaaaaaaaaaaaaaaaaaaaaaaaaaaaaaaaaaaaaaaaaaaaa
aaaaaaaaaaaaaaaaaaaaaaaaaaaaaaaaaaaaaaaaaaaaaaaaaaaaaaaaaaaa
aaaaaaaaaaaaaaaaaaaaaaaaaaaaaaaaaaaaaaaaaaaaaaaaaaaaaaaaaaaa
aaaaaaaaaaaaaaaaaaaaaaaaaaaaaaaaaaaaaaaaaaaaaaaaaaaaaaaaaaaa
aaaaaaaaaaaaaaaaaaaaaaaaaaaaaaaaaaaaaaaaaaaaaaaaaaaaaaaaaaaa
aaaaaaaaaaaaaaaaaaaaaaaaaaaaaaaaaaaaaaaaaaaaaaaaaaaaaaaaaaaa
aaaaaaaaaaaaaaaaaaaaaaaaaaaaaaaaaaaaaaaaaaaaaaaaaaaaaaaaaaaa
aaaaaaaaaaaaaaaaaaaaaaaaaaaaaaaaaaaaaaaaaaaaaaaaaaaaaaaaaaaa
aaaaaaaaaaaaaaaaaaaaaaaaaaaaaaaaaaaaaaaaaaaaaaaaaaaaaaaaaaaa
aaaaaaaaaaaaaaaaaaaaaaaaaaaaaaaaaaaaaaaaaaaaaaaaaaaaaaaaaaaa
aaaaaaaaaaaaaaaaaaaaaaaaaaaaaaaaaaaaaaaaaaaaaaaaaaaaaaaaaaaa
aaaaaaaaaaaaaaaaaaaaaaaaaaaaaaaaaaaaaaaaaaaaaaaaaaaaaaaaaaaa
aaaaaaaaaaaaaaaaaaaaaaaaaaaaaaaaaaaaaaaaaaaaaaaaaaaaaaaaaaaa
aaaaaaaaaaaaaaaaaaaaaaaaaaaaaaaaaaaaaaaaaaaaaaaaaaaaaaaaaaaa
aaaaaaaaaaaaaaaaaaaaaaaaaaaaaaaaaaaaaaaaaaaaaaaaaaaaaaaaaaaa
aaaaaaaaaaaaaaaaaaaaaaaaaaaaaaaaaaaaaaaaaaaaaaaaaaaaaaaaaaaa
aaaaaaaaaaaaaaaaaaaaaaaaaaaaaaaaaaaaaaaaaaaaaaaaaaaaaaaaaaaa
wwwwwwwwwwwwwwwwwwwwwwwwwwwwwwwwwwwwwwwwwwwwwwwwwwwwwwwwwwww
"}