"a" = (/turf,/area)
"b" = (/obj/Brick,/turf,/area)
"c" = (/obj/OneWayBlock{tag = "icon-OneWay (WEST)"; icon_state = "OneWay"; dir = 8},/turf,/area)
"d" = (/obj/Brick/BrickTop,/turf,/area)
"e" = (/obj/Platform,/turf,/area)
"f" = (/obj/Sparkle,/turf,/area)
"g" = (/mob/Eagle,/turf,/area)
"h" = (/obj/Collectible/Emerald,/turf,/area)
"i" = (/obj/GooBlock,/turf,/area)
"j" = (/obj/OneWayBlock{tag = "icon-OneWay (EAST)"; icon_state = "OneWay"; dir = 4},/turf,/area)
"k" = (/mob/Crawler,/turf,/area)
"l" = (/obj/WoodBlock,/turf,/area)
"m" = (/obj/Checkpoint,/turf,/area)
"n" = (/mob/FlierHorizontal{step_x = 17},/turf,/area)
"o" = (/obj/Hazard/Spikes{tag = "icon-Spikes"; icon_state = "Spikes"; dir = 2},/turf,/area)
"p" = (/obj/Collectible/Emerald,/obj/Conveyor/Switched{dir = 8},/turf,/area)
"q" = (/obj/SwitchBlock,/turf,/area)
"r" = (/obj/Conveyor/Switched,/turf,/area)
"s" = (/obj/Hazard/Spikes{tag = "icon-Spikes (EAST)"; icon_state = "Spikes"; dir = 4},/turf,/area)
"t" = (/mob/FlierVertical,/turf,/area)
"u" = (/obj/Hazard/Spikes{tag = "icon-Spikes (WEST)"; icon_state = "Spikes"; dir = 8},/turf,/area)
"v" = (/obj/Hazard/Spikes/Acidblock,/turf,/area)
"w" = (/obj/Brick/BrickTop,/obj/Conveyor,/turf,/area)
"x" = (/obj/Brick/BrickTop,/obj/Conveyor{dir = 8; icon_state = "Conveyor0"; tag = "icon-Conveyor0"},/turf,/area)
"y" = (/obj/Platform,/mob/Crawler,/turf,/area)
"z" = (/obj/Water/Surface,/turf,/area)
"A" = (/obj/Water,/turf,/area)
"B" = (/obj/Water,/obj/Collectible/Emerald,/turf,/area)
"C" = (/obj/ToggleBlock,/turf,/area)
"D" = (/obj/ToggleBlock{tag = "icon-On"; icon_state = "On"},/turf,/area)
"E" = (/obj/Hazard/Spikes,/turf,/area)
"F" = (/obj/Brick/Cracked,/turf,/area)
"G" = (/obj/Spawner/LitBomb,/turf,/area)
"H" = (/obj/PlayerStart,/turf,/area)
"I" = (/mob/FlierHorizontal,/mob/LitBomb/Big{step_x = 9; step_y = 8},/turf,/area)
"J" = (/obj/Conveyor,/turf,/area)

(1,1,1) = {"
aaaaaaaaaaaaaaaaaaaaaaaaaaaaaaaaaaaaaaaaaaaaaabbbaaaaaaaaaaa
aaaaaaaaaaaaaaaaaaaaaaaaaaaaaaaaaaaaaaaaaaaaaacabaaaaaaaaaaa
aaaaaaaaaaaaaaaaaaaaaaaaaaaaaaaaaaaaaaaaaaaaaadabaaaaaaaaaaa
aaaaaaaaaaaaaaaaaaaaaaaaaaaaaaaaaaaaaaaaaaaaaabebaaaaaaaaaaa
aaaaaaaaaaaaaaaaaaaaaaaaaaaaaaaaaaaaaaaaaaaaaabfbaaaaaaaaaaa
aaaaaaaaaaaaaaaaaaaaaaaaaaaaaagaaaaaaaaaaaaaaababaaaaaaaaaaa
aaaaaaaaaaaaaaaaaaaaaaaaaaaahaaaaaaaaaaaaaaaaabfbaaaaaaaaaaa
aaaaaaaaaaaaaaaaaaaaaaaaaaaaaaaaaaaaaaaaaaaaaababaaaaaaaaaaa
aaaaaaaaaaaaaaaaaaadddaiaiadddaaaaaaaaaaaaaaaabfbaaaaaaaaaaa
aaaaaaaaajakaacaaaaaaaaaaaaaaaaaaaaaaaaaaaaaaababaaaaaaaaaaa
aaaaaaaaaallllaaaaaaaaaaaaaaaaaaddfdaaaaaaaacabfbaaaaaaaaaaa
aaaaaaaaaaaaahaaaaaaahhaaaaaaaaaaafaaaaaaahdddbabaaaaaaaaaaa
aaaaaaaaaaaaaaaaaaaaaamanaaaaaaaaaaaaaaaaadbbbbfbaaaaaaaaaaa
aaaaaaaaaaaadddaaaaaooooaabkbaaaooooaaaaadbbbbbabaaaaaaaaaaa
aaaaaaaaaaaabbbfaaaaahaaapbqbrhaaahaaaaafbbbbbbfbaaaaaaaaaaa
aaaaaaaaaaaabsaaaahaaaaaaaaaaaaaaaaaahataaubbbbabaaaaaaaaaaa
vvvvvvvvvvvvbsaaaaaaaaaaaaaaaaaaaaaaaaaaaaubbbbfbaaaaaaaaaaa
baaaaaaaabbbbdddddddaaaawwweexxxaafadddddddbbbbabaaaaaaaaaaa
baaahaadaaaaaaaaaaaaaaaaaaaeeaaaaaaaaaaaabbbbbbfbaaaaaaaaaaa
baaaaafbahhhhmaaaaaaaadaahaeyahaabzzzzzzzbbbbbbabaaaaaaaaaaa
bahaaaabddddddaaaaaaafbvvvvvvvvvvbAAAAAAAbbbbbbfbaaaaaaaaaaa
baafaaaaaaaaabaaaaaaaabaaaaaaaaaabABAAABAbbbbbbabaaaaaaaaaaa
baaaaaaaaddddbaaaaaaaabaaaadzddddbAAABAAAbbbbbbfbaaaaaaaaaaa
bhaafaaaaaaaaaaaaaaaaabaaaabAAAAAAAAAAAAAbbbbbbabaaaaaaaaaaa
bfaaaahaadddaaaaaaaaafbaaafbbbbbbbbbbbbbbbaaabbfbaaaaaaaaaaa
baaaaaaaaaabfaaaaaaaaabfaaabaqaaqaaaaaaaaCaqabbabaaaaaaaaaaa
baafaaafaaabddaamaaaaabaabbbaaaaaaaaaaaaaCaaabbfbaaaaaaaaaaa
baaaaaaaaaabbbddddddddbaaaaaaaaaaaaaaaaaaCaaabbabaaaaaaaaaaa
bvvvvvvvvvvbbbbbbbbbbbbddddDDaCCaDDdddddddDDDbbfbaaaaaaaaaaa
bbbbbbbbbbbbbbbbbbbbbbbbbbbaaaaaaaabbbbbbbaaabbabbbbbbbaaaaa
bbbbbbbbbbbbbbbbbbbbbbbbbbbEEEEEEEEbbbbbbbaaaaafaaaaaabaaaaa
aaaaaaaaaaaaaaaaaaaaaaaaaaaaabahaFaaaaaGaaaaaaafaaaaaabaaaaa
aaaaaaaaaaaaaaaaaaaaaaaaaaaaabhahFaaaaaaaaamHaaaaaaaaabaaaaa
aaaaaaaaaaaaaaaaaaaaaaaaaaaaabdddddddddddddbdddddaaaaabaaaaa
aaaaaaaaaaaaaaaaaaaaaaaaaaaaaaaaaaaaaaaaaaaaaaaaFaaaaabaaaaa
aaaaaaaaaaaaaaaaaaaaaaaaaaaaaaaaaaaaIaaaaaaaaahaFaaaaabaaaaa
aaaaaaaaaaaaaaaaaaaaaaaaaaaaaaaaaaaaaFFFFFaaaaddddddddbaaaaa
aaaaaaaaaaaaaaaaaaaaaaaaaaaaaaaaaaaaaFFFFFaaaaaaaaaaaaaaaaaa
aaaaaaaaaaaaaaaaaaaaaaaaaaaaaaaaaaaaaFFFFFaaaaaaaaaaaaaaaaaa
aaaaaaaaaaaaaaaaaaaaaaaaaaaaaaaaaaaaaFFFFFaaaaaaaaaaaaaaaaaa
aaaaaaaaaaaaaaaaaaaaaaaaaaaaaaaaaaaaaFFFFFaaaaaaaaaaaaaaaaaa
aaaaaaaaaaaaaaaaaaaaaaaaaaaaaaaaaaaaaFFFFFaaaaaaaaaaaaaaaaaa
aaaaaaaaaaaaaaaaaaaaaaaaaaaaaaaaaaaaaaaaaaaaaaaaaaaaaaaaaaaa
aaaaaaaaaaaaaaaaaaaaaaaaaaaaaaaaaaaaaaaaaaaaaaaaaaaaaaaaaaaa
aaaaaaaaaaaaaaaaaaaaaaaaaaaaaaaaaaaaaaaaaaaaaaaaaaaaaaaaaaaa
aaaaaaaaaaaaaaaaaaaaaaaaaaaaaaaaaaaaaaaaaaaaaaaaaaaaaaaaaaaa
aaaaaaaaaaaaaaaaaaaaaaaaaaaaaaaaaaaaaaaaaaaaaaaaaaaaaaaaaaaa
aaaaaaaaaaaaaaaaaaaaaaaaaaaaaaaaaaaaaaaaaaaaaaaaaaaaaaaaaaaa
aaaaaaaaaaaaaaaaaaaaaaaaaaaaaaaaaaaaaaaaaaaaaaaaaaaaaaaaaaaa
aJJJaaaaaaaaaaaaaaaaaaaaaaaaaaaaaaaaaaaaaaaaaaaaaaaaaaaaaaaa
arrraaaaaaaaaaaaaaaaaaaaaaaaaaaaaaaaaaaaaaaaaaaaaaaaaaaaaaaa
aaaaaaaaaaaaaaaaaaaaaaaaaaaaaaaaaaaaaaaaaaaaaaaaaaaaaaaaaaaa
aaaaaaaaaaaaaaaaaaaaaaaaaaaaaaaaaaaaaaaaaaaaaaaaaaaaaaaaaaaa
aaaaaaaaaaaaaaaaaaaaaaaaaaaaaaaaaaaaaaaaaaaaaaaaaaaaaaaaaaaa
aaaaaaaaaaaaaaaaaaaaaaaaaaaaaaaaaaaaaaaaaaaaaaaaaaaaaaaaaaaa
aaaaaaaaaaaaaaaaaaaaaaaaaaaaaaaaaaaaaaaaaaaaaaaaaaaaaaaaaaaa
aaaaaaaaaaaaaaaaaaaaaaaaaaaaaaaaaaaaaaaaaaaaaaaaaaaaaaaaaaaa
aaaaaaaaaaaaaaaaaaaaaaaaaaaaaaaaaaaaaaaaaaaaaaaaaaaaaaaaaaaa
aaaaaaaaaaaaaaaaaaaaaaaaaaaaaaaaaaaaaaaaaaaaaaaaaaaaaaaaaaaa
EEEEEEEEEEEEEEEEEEEEEEEEEEEEEEEEEEEEEEEEEEEEEEEEEEEEEEEEEEEE
"}
