"aa" = (/turf/Nothing,/area)
"ab" = (/obj/Autojoin/GrassCliff,/turf/Nothing,/area)
"ac" = (/obj/OneWayBlock{tag = "icon-OneWay (WEST)"; icon_state = "OneWay"; dir = 8},/turf/Nothing,/area)
"ad" = (/obj/OneWayBlock/MobHint{tag = "icon-OneWay (EAST)"; icon_state = "OneWay"; dir = 4},/turf/Nothing,/area)
"ae" = (/mob/Crawler,/turf/Nothing,/area)
"af" = (/obj/OneWayBlock/MobHint{tag = "icon-OneWay (WEST)"; icon_state = "OneWay"; dir = 8},/turf/Nothing,/area)
"ag" = (/obj/WoodBlock,/turf/Nothing,/area)
"ah" = (/obj/Platform,/turf/Nothing,/area)
"ai" = (/mob/Eagle,/turf/Nothing,/area)
"aj" = (/obj/Autojoin/SigmaPlatform,/turf/Nothing,/area)
"ak" = (/obj/Sparkle,/turf/Nothing,/area)
"al" = (/obj/Collectible/Emerald,/turf/Nothing,/area)
"am" = (/obj/Autojoin/SigmaPlatform,/obj/Autojoin/SigmaPlatform/Pipe,/turf/Nothing,/area)
"an" = (/obj/Autojoin/SigmaPlatform,/obj/Decorative/Sigma1/Tech,/turf/Nothing,/area)
"ao" = (/obj/Autojoin/SigmaPlatform,/obj/Decorative/Sigma1/Vent,/turf/Nothing,/area)
"ap" = (/obj/Autojoin/SigmaPlatform,/obj/Autojoin/SigmaPlatform/Pipe{dir = 4},/turf/Nothing,/area)
"aq" = (/mob/PlatformWalker,/turf/Nothing,/area)
"ar" = (/obj/Brick/BrickTop,/turf/Nothing,/area)
"as" = (/obj/GooBlock,/turf/Nothing,/area)
"at" = (/obj/Decorative/Grass,/turf/Nothing,/area)
"au" = (/obj/Decorative/Flower,/obj/Decorative/Grass,/turf/Nothing,/area)
"av" = (/obj/Ramp/Ramp1R,/obj/Decorative/Grass,/turf/Nothing,/area)
"aw" = (/obj/Checkpoint,/turf/Nothing,/area)
"ax" = (/obj/Ramp/Ramp1R,/turf/Nothing,/area)
"ay" = (/obj/Hazard/Spikes{tag = "icon-Spikes"; icon_state = "Spikes"; dir = 2},/turf/Nothing,/area)
"az" = (/mob/FlierHorizontal{step_x = 17},/turf/Nothing,/area)
"aA" = (/obj/Autojoin/BackgroundGrassCliff,/obj/Autojoin/GrassCliff,/turf/Nothing,/area)
"aB" = (/obj/Brick,/turf/Nothing,/area)
"aC" = (/obj/Autojoin/BackgroundGrassCliff,/turf/Nothing,/area)
"aD" = (/obj/Collectible/Powerup/Jump,/turf/Nothing,/area)
"aE" = (/obj/Collectible/Emerald,/obj/Conveyor/Switched{dir = 8},/turf/Nothing,/area)
"aF" = (/obj/SwitchBlock,/turf/Nothing,/area)
"aG" = (/obj/Conveyor/Switched,/turf/Nothing,/area)
"aH" = (/obj/Hazard/Spikes{tag = "icon-Spikes (EAST)"; icon_state = "Spikes"; dir = 4},/turf/Nothing,/area)
"aI" = (/obj/PlayerStart,/turf/Nothing,/area)
"aJ" = (/mob/FlierVertical,/turf/Nothing,/area)
"aK" = (/obj/Hazard/Spikes{tag = "icon-Spikes (WEST)"; icon_state = "Spikes"; dir = 8},/turf/Nothing,/area)
"aL" = (/obj/Hazard/Spikes/Acidblock,/obj/Autojoin/BackgroundGrassCliff,/turf/Nothing,/area)
"aM" = (/obj/Decorative/Grass,/mob/PlatformWalker,/turf/Nothing,/area)
"aN" = (/obj/Hazard/Spikes{tag = "icon-Spikes (WEST)"; icon_state = "Spikes"; dir = 8},/obj/Decorative/Grass,/turf/Nothing,/area)
"aO" = (/obj/Autojoin/GrassCliff,/obj/Autojoin/BackgroundGrassCliff,/turf/Nothing,/area)
"aP" = (/obj/Brick/BrickTop,/obj/Conveyor,/turf/Nothing,/area)
"aQ" = (/obj/Brick/BrickTop,/obj/Conveyor{dir = 8; icon_state = "Conveyor0"; tag = "icon-Conveyor0"},/turf/Nothing,/area)
"aR" = (/obj/Collectible/Emerald,/obj/Autojoin/BackgroundGrassCliff,/turf/Nothing,/area)
"aS" = (/obj/Brick/BrickTop,/obj/Autojoin/BackgroundGrassCliff,/turf/Nothing,/area)
"aT" = (/obj/Decorative/Flower,/mob/PlatformWalker,/turf/Nothing,/area)
"aU" = (/obj/Sparkle,/obj/Autojoin/BackgroundGrassCliff,/turf/Nothing,/area)
"aV" = (/obj/Brick,/obj/Autojoin/BackgroundGrassCliff,/turf/Nothing,/area)
"aW" = (/obj/Platform,/mob/Crawler,/turf/Nothing,/area)
"aX" = (/obj/Water/Surface,/turf/Nothing,/area)
"aY" = (/obj/Hazard/Spikes/Acidblock,/turf/Nothing,/area)
"aZ" = (/obj/Water,/turf/Nothing,/area)
"ba" = (/mob/IronCrate,/turf/Nothing,/area)
"bb" = (/mob/Squishy,/turf/Nothing,/area)
"bc" = (/obj/Water,/obj/Collectible/Emerald,/turf/Nothing,/area)
"bd" = (/obj/Autojoin/GrassCliff,/obj/Water,/turf/Nothing,/area)
"be" = (/obj/Autojoin/BackgroundGrassCliff,/obj/Collectible/Emerald,/turf/Nothing,/area)
"bf" = (/obj/Ramp/Ramp1L,/turf/Nothing,/area)
"bg" = (/obj/Decorative/Flower,/obj/Autojoin/BackgroundGrassCliff,/turf/Nothing,/area)
"bh" = (/obj/ToggleBlock,/turf/Nothing,/area)
"bi" = (/obj/Decorative/Flower,/turf/Nothing,/area)
"bj" = (/obj/Decorative/Mushroom/Small,/turf/Nothing,/area)
"bk" = (/obj/ToggleBlock{tag = "icon-On"; icon_state = "On"},/turf/Nothing,/area)
"bl" = (/obj/Hazard/Spikes,/turf/Nothing,/area)
"bm" = (/obj/Autojoin/GrassCliff,/obj/Autojoin/BackgroundGrassCliff,/obj/Autojoin/BackgroundGrassCliff,/turf/Nothing,/area)
"bn" = (/obj/Conveyor/Switched/Off/West{SignalChannel = "BrickBreaker"},/turf/Nothing,/area)
"bo" = (/obj/Spawner/LitBomb,/obj/Autojoin/BackgroundGrassCliff,/turf/Nothing,/area)
"bp" = (/obj/Brick/Cracked/Stone,/turf/Nothing,/area)
"bq" = (/obj/Autojoin/BackgroundGrassCliff,/obj/Decorative/Mushroom/Small,/turf/Nothing,/area)
"br" = (/obj/Checkpoint,/obj/Autojoin/BackgroundGrassCliff,/turf/Nothing,/area)
"bs" = (/obj/Autojoin/BackgroundGrassCliff,/obj/Decorative/Mushroom,/turf/Nothing,/area)
"bt" = (/obj/Autojoin/BackgroundGrassCliff,/obj/SwitchBlock{SignalChannel = "BrickBreaker"},/turf/Nothing,/area)
"bu" = (/obj/Autojoin/BackgroundGrassCliff,/obj/Brick/Cracked/Stone,/turf/Nothing,/area)
"bv" = (/obj/Autojoin/BackgroundGrassCliff,/mob/LitBomb/Big{step_x = 0; step_y = 0},/turf/Nothing,/area)
"bw" = (/obj/Ramp/Ramp1R,/obj/Autojoin/BackgroundGrassCliff,/turf/Nothing,/area)
"bx" = (/mob/FlierHorizontal,/turf/Nothing,/area)
"by" = (/obj/Autojoin/BackgroundGrassCliff,/obj/Hazard/Spikes{tag = "icon-Spikes"; icon_state = "Spikes"; dir = 2},/turf/Nothing,/area)
"bz" = (/obj/Conveyor,/turf/Nothing,/area)
"bA" = (/obj/Hazard/Spikes,/obj/Autojoin/BackgroundGrassCliff,/turf/Nothing,/area)

(1,1,1) = {"
aaaaaaaaaaaaaaaaaaaaaaaaaaaaaaaaaaaaaaaaaaaaaaaaaaaaaaaaaaaaaaaaaaaaaaaaaaaaaaaaaaaaaaaaaaaaababababaaaaaaaaaaaaaaaaaaaa
aaaaaaaaaaaaaaaaaaababaaaaaaaaaaaaaaaaaaaaaaaaaaaaaaaaaaaaaaaaaaaaaaaaaaaaaaaaaaaaaaaaaaaaaaacaaababaaaaaaaaaaaaaaaaaaaa
aaaaaaaaaaaaaaaaaaababaaaaaaabaaaaaaaaaaaaaaaaadaaaeaaaaafaaaaaaaaaaaaaaaaaaaaaaaaaaaaaaaaaaabaaababaaaaaaaaaaaaaaaaaaaa
aaaaaaaaaaaaaaabababababababababababaaaaaaaaaaaaagagagagaaaaaaaaaaaaaaaaaaaaaaaaaaaaaaaaaaaaabahababaaaaaaaaaaaaaaaaaaaa
aaaaaaaaaaabaaaaaaababaaaaaaaaaaabaaaaaaaaaaaaaaaaaaaaaaaaaaaaaiaaaaaaaaaaaaajajajajajaaaaaaabakababaaaaaaaaaaaaaaaaaaaa
aaaaaaaaaaabaaaaaaababaaaaaaaaaaaaaaaaaaaaaaaaaaaaaaaaaaalaaaaaaaaaaaaaaaaaaamanajaoapaaaaaaabaaababaaaaaaaaaaaaaaaaaaaa
aaaaaaababababababababababaaaaaaaaaaaqaaaaaaaaaaaaaaaaaaaqaaaaaaaaaaaaaaaaaaamajajaoapaaaaaaabakababaaaaaaaaaaaaaaaaaaaa
aaaaaaababababababababababaaaaaaararararaaasaaasaaasaaarararaaaaaaaaaaaaaaaaamajajaoapaaaaaaabaaababaaaaaaaaaaaaaaaaaaaa
aaaaaaaaaaabaaaaaaababaaaaaaaaaaaaaaaaaaaaaaaaaaaaaaaaaaaaaaaaaaaaaaaaaaaaaaajajajajajaaaaaaabakababaaaaaaaaaaaaaaaaaaaa
aaaaaaaaaaabaaaaaaababaaaaaaaaaaaaaaaaaaaaaaaaaaaaaaaaaaaaaaaaaaararakaraaaaaaaaaaaaaaaaaaaaabaaababaaaaaaaaaaaaaaaaaaaa
aaaaaaaaaaatatataaaaaaaaaaaaaaaaaaaaaaaaaaalalaaaaaaaaaaaaaaaaaaaaaaakaaaaaaaaaaaaaaaaatauavabakababaaaaaaaaaaaaaaaaaaaa
aaaaaaababababababaaaaaaaaalaaaaaaaaaaaaaqaaawaaaaaaaaaaaaaaaaaaaaaaaaaaaaaaaaaaaaaaaxababababaaababaaaaaaaaaaaaaaaaaaaa
aaaaaaaaaaababababaaaaaaaaaqaaaaaaaaaaaaayayayayazaaaaaaaaaaaaaaayayayayaaaaaaaaaaaxabababababakababaaaaaaaaaaaaaaaaaaaa
aaaaaaaaaaabaAaAabaaaaaaabababaaaaaaaaaaaaaaaaaaaaaaaBaeaBaaaaaaaaaaaaaaaaaaaaaaaaababababababaaababaaaaaaaaaaaaaaaaaaaa
aaaaaaaaaaaaaCaCaaaaaaaaabababakaaaDaaaDaaalaaaaaaaEaBaFaBaGalaaaaaaalaaaaaaaaaaaaababababababakababaaaaaaaaaaaaaaaaaaaa
aaaaaaaaaaaaaCaCaaaaaaaaabaHaaaaaIaaalaaaaaaaaaaaaaaaaaaaaaaaaaaaaaaaaaaaaalaaaJaaaaaKababababaaababaaaaaaaaaaaaaaaaaaaa
aLaLaLaLaLaLaLaLaLaLaLaLabaHatatauatatataaaaaaaaaqaaaaaaaaaaaaaaaaaaaaaaauataMatatataNababababakababaaaaaaaaaaaaaaaaaaaa
aOaCaCaCaCaCaCaCaCaOaOaOababababababababaaaaaaaaaPaPaPahahaQaQaQaaaaaaaaabababababababababababaaababaaaaaaaaaaaaaaaaaaaa
aOaCaCaCaRaCaCaSaCaCaCaCaaaaaaaaaaaaaaaaaaaaaTaaaaaaaaahahaaaaaaaaaaaaaaaaaaaaaaaaababababababakababaaaaaaaaaaaaaaaaaaaa
aOaCaCaCaCaCaUaVaCaRaRaRalawaaaaaaaaaaaaaaaaabaaaaalaaahaWaaalaaaaabaXaXaXaXaXaXaXababababababaaababaaaaaaaaaaaaaaaaaaaa
aOaCaRaCaCaCaCaVaSaSaSaSararaaaaaaaaaaaaaaaaabaYaYaYaYaYaYaYaYaYaYabaZaZaZaZaZaZaZabababbaababakababaaaaaaaaaaaaaaaaaaaa
aOaCaCaUaCaCaCaCaCaCaCaCaaaBaaaaaaaaaaaaaaaaabaaaaaaaaaaaaaaaaaabbabaZbcaZaZaZbcaZabababbaababaaababaaaaaaaaaaaaaaaaaaaa
aOaCaCaCaCaCaCaCaCaSaSaSaraBaaaaaaaaaaaaaaakabaaalaaababaXbdabababbdaZaZaZbcaZaZaZababababababakababaaaaaaaaaaaaaaaaaaaa
aOaRaCaCaUaCaCaCaCaCaCaCaaaaaaaaaaaaaaaaaaaCaOaCbeaCaOabaZaZaZaZaZaZaZaZaZaZaZaZaZababababababaaababaaaaaaaaaaaaaaaaaaaa
aOaUaCaCaCaCaRaCaCaOaOaObfaaaaaaaaaaaaaaaaaCaOaCaCaCaOabababababababababababababababaaaaaaababakababaaaaaaaaaaaaaaaaaaaa
aOaCaCaCaCaCaCaCaCaCaCaOabbfaaaaaaaaaaaaaCbgaOaCaCaOaOabaaaFaaaaaFaaaaaaaaaaaaaaaabhaaaFaaababaaababaaaaaaaaaaaaaaaaaaaa
aOaCaCaUaCaCaCaUaCaCaCaOababbfaaawaabiaaaCaOaOaaaaabababaaaaaaaaaaaaaaaaaaaaaaaaaabhaaaaaaabaOaUaOabaaaaaaaaaaaaaaaaaaaa
aOaCaCaCaCaCaCaCaCaCaCaOababababababababaOaOaOaaaaaaaaaaaaaaaaaaaaaaaaaaaabjaaaaaabhaaaaaaabaOaCaOabaaaaaaaaaaaaaaaaaaaa
aOaLaLaLaLaLaLaLaLaLaLaOabababababababababababababababbkbkaabhbhaabkbkabababababababbkbkbkabaOaUaOababababababababaaaaaa
abababababababababababababababaaaabaabababababababababaaaaaaaaaaaaaaaaabaOaOaOaOaOaOaCaCaCaOaOaCaOaOaOaOaOaOaOababaaaaaa
abababababababababababababababaaaabaabababababababababblblblblblblblblabaOaOaObmaOaOaCaCaCaCaCaUaCaCaCaCaCaCaOababaaaaaa
aaayayayayaaaaaaaaayayayababaaaabnbnababaOaOaOaOaOaOababababababababababaCaCaCboaCaCaCaCaCaCaCaUaCaCaCaCaCaCaOababaaaaaa
aaaaaaaaaaaaaaaaaaaaaaaaababaaaaaaaaayaaaCaCaCaCaCaOabababalaaalaabpaaaaaCaCaCaCbqaCaCbrbqbsaCaCaCaCaCaCaCaCaOababaaaaaa
aaaaaaaaaaaaaaaaaaaaaaaaababaaaaaaaaaaaaaCaCaCaCaCaOabababaaalaaalbpaaaaaCaCaOaOaOaOaOaOaOaOaOaOaOaCaCaCaCaCaOababaaaaaa
aaaaaaaaaaaaaaaaaaaaaaaaababaaaaaaaaaaaabtaCaCaCaCaOaOaOaOaOaOaOaOaOababaOaOaOabaOaOabababababaObuaCaCaCaCaCaOababaaaaaa
aaaaaaaaaaaaaaaaaaaaaaaaababaaaaaaaaaaaaaCaCaCaCaCaCaCaCaCaCaCaCaCaCaaaaaaaaaaaaaCaCaaaaaaaaalaCbubvaCbsaCbwaOababaaaaaa
aaaaaaaaaaaaaaaaaaaaaaababababaaaaaaaaaaaCbqaCbsaCbqaCaCbsaCaCbqaCaCaaaaaaaaaaaaaCaCaaaaaaaaabaOaOaOaOaOaOaOaOababaaaaaa
aaaaaaaaaaaaaaaaaaaaaaababababaaaaaaaaaaaOaOaOaOaOaOaOaOaOaOaOaOaOaOabbfaaaaaaaaaCaCaaaaaaaaabababaOaOababababababaaaaaa
aaaaaaaaaaaaaaaaaaaaaaaaaaaaaaagaabiaaababababaOaOababaOaOababaOaOabababaabxaaaaaCaCaaaaaaaaaaayaybybyaaaaaaayayaaaaaaaa
aaaaaaaaaaaaaaaaaaaaabababababaaababababababaybybyayaybybyayaybybyayababaaaaaaaaaCaCaaaaaaaaaaaaaaaCaCaaaaaaaaaaaaaaaaaa
aaaaaaaaaaaaaaaaaaaaabababababaaababababababaaaCaCaaaaaCaCaaaaaCaCaaaaaaaaaaaaaaaCaCaaaaaaaaaaaaaaaCaCaaaaaaaaaaaaaaaaaa
aaaaaaaaaaaaaaaaaaaaabababababblababababaaaaaaaCaCaaaaaCaCaaaaaCaCaaaaaaaaaaaaaaaCaCaaaaaaaaaaaaaaaCaCaaaaaaaaaaaaaaaaaa
aaaaaaaaaaaaaaaaaaaaabaOaOaOabababaOabaaaaaaaaaCaCaaaaaCaCaaaaaCaCaaaaaaaaaaaaaaaCaCaaaaaaaaaaaaaaaCaCaaaaaaaaaaaaaaaaaa
aaaaaaaaaaaaaaaaaaaaaaaCaCaCaCaCaCaCaaaaaaaaaaaCaCaCaCaCaCaaaaaCaCaaaaaaaaaaaaaaaCaCaCaCaCaCaCaCaCaCaCaaaaaaaaaaaaaaaaaa
aaaaaaaaaaaaaaaaaaaaaaaCaCaCaCaCaCaCaaaaaaaaaaaCaCaCaCaCaCaaaaaCaCaaaaaaaaaaaaaaaCaCaCaCaCaCaCaCaCaCaCaaaaaaaaaaaaaaaaaa
aaaaaaaaaaaaaaaaaaaaaaaCaCaCaCaCaCaCaaaaaaaaaaaCaCaaaaaaaaaaaaaCaCaaaaaaaaaaaaaaaaaaaaaaaaaCaCaaaaaaaaaaaaaaaaaaaaaaaaaa
aaaaaaaaaaaaaaaaaaaaaaaCaCaCaCaCaCaCaaaaaaaaaaaCaCaaaaaaaaaaaaaCaCaCaCaCaCaCaaaaaaaaaaaaaaaCaCaaaaaaaaaaaaaaaaaaaaaaaaaa
aaaaaaaaaaaaaaaaaaaaaaaCaCaaaaaaaCaCaaaaaaaaaaaCaCaaaaaaaaaaaaaCaCaCaCaCaCaCaaaaaaaaaaaaaaaCaCaaaaaaaaaaaaaaaaaaaaaaaaaa
aaaaaaaaaaaaaaaaaaaaaaaCaCaaaaaaaCaCaaaaaaaaaaaCaCaaaaaaaaaaaaaCaCaaaaaaaCaCaaaaaaaaaaaaaaaCaCaaaaaaaaaaaaaaaaaaaaaaaaaa
aabzbzbzaaaaaaaaaaaaaaaCaCaaaaaaaCaCaaaaaaaaaaaCaCaaaaaaaaaaaaaCaCaaaaaaaCaCaCaCaCaCaCaCaCaCaCaaaaaaaaaaaaaaaaaaaaaaaaaa
aaaGaGaGaaaaaaaaaaaaaaaCaCaCaCaCaCaCaaaaaaaaaaaCaCaaaaaaaaaaaaaCaCaaaaaaaCaCaCaCaCaCaCaCaCaCaCaaaaaaaaaaaaaaaaaaaaaaaaaa
aaaaaaaaaaaaaaaaaaaaaaaCaCaCaCaCaCaCaaaaaaaaaaaCaCaaaaaaaaaaaaaCaCaaaaaaaaaaaaaaaaaaaaaaaaaaaaaaaaaaaaaaaaaaaaaaaaaaaaaa
aaaaaaaaaaaaaaaaaaaaaaaCaCaCaCaCaCaCaaaaaaaaaaaCaCaaaaaaaaaaaaaCaCaaaaaaaaaaaaaaaaaaaaaaaaaaaaaaaaaaaaaaaaaaaaaaaaaaaaaa
aaaaaaaaaaaaaaaaaaaaaaaCaCaCaCaCaCaCaaaaaaaaaaaCaCaaaaaaaaaaaaaCaCaaaaaaaaaaaaaaaaaaaaaaaaaaaaaaaaaaaaaaaaaaaaaaaaaaaaaa
aaaaaaaaaaaaaaaaaaaaaaaCaCaCaCaCaCaCaaaaaaaaaaaCaCaaaaaaaaaaaaaCaCaaaaaaaaaaaaaaaaaaaaaaaaaaaaaaaaaaaaaaaaaaaaaaaaaaaaaa
aaaaaaaaaaaaaaaaaaaaaaaCaCaCaCaCaCaCaaaaaaaaaaaCaCaaaaaaaaaaaaaCaCaaaaaaaaaaaaaaaaaaaaaaaaaaaaaaaaaaaaaaaaaaaaaaaaaaaaaa
aaaaaaaaaaaaaaaaaaaaaaaCaCaCaCaCaCaCaaaaaaaaaaaCaCaaaaaaaaaaaaaCaCaaaaaaaaaaaaaaaaaaaaaaaaaaaaaaaaaaaaaaaaaaaaaaaaaaaaaa
aaaaaaaaaaaaaaaaaaaaaaaCaCaCaCaCaCaCaaaaaaaaaaaCaCaaaaaaaaaaaaaCaCaaaaaaaaaaaaaaaaaaaaaaaaaaaaaaaaaaaaaaaaaaaaaaaaaaaaaa
aaaaaaaaaaaaaaaaaaaaaaaCaCaCaCaCaCaCaaaaaaaaaaaCaCaaaaaaaaaaaaaCaCaaaaaaaaaaaaaaaaaaaaaaaaaaaaaaaaaaaaaaaaaaaaaaaaaaaaaa
blblblblblblblblblblblbAbAbAbAbAbAbAblblblblblbAbAblblblblblblbAbAblblblblblblblblblblblblblblblblblblblblblblblblblblbl
"}
