"aa" = (/turf,/area)
"ab" = (/obj/Autojoin/GrassCliff,/turf,/area)
"ac" = (/obj/OneWayBlock{tag = "icon-OneWay (WEST)"; icon_state = "OneWay"; dir = 8},/turf,/area)
"ad" = (/obj/OneWayBlock/MobHint{tag = "icon-OneWay (EAST)"; icon_state = "OneWay"; dir = 4},/turf,/area)
"ae" = (/mob/Crawler,/turf,/area)
"af" = (/obj/OneWayBlock/MobHint{tag = "icon-OneWay (WEST)"; icon_state = "OneWay"; dir = 8},/turf,/area)
"ag" = (/obj/WoodBlock,/turf,/area)
"ah" = (/obj/Platform,/turf,/area)
"ai" = (/mob/Eagle,/turf,/area)
"aj" = (/obj/Sparkle,/turf,/area)
"ak" = (/obj/Collectible/Emerald,/turf,/area)
"al" = (/obj/Brick/BrickTop,/turf,/area)
"am" = (/obj/GooBlock,/turf,/area)
"an" = (/obj/Ramp/Ramp1R,/turf,/area)
"ao" = (/obj/Checkpoint,/turf,/area)
"ap" = (/obj/Hazard/Spikes{tag = "icon-Spikes"; icon_state = "Spikes"; dir = 2},/turf,/area)
"aq" = (/mob/FlierHorizontal{step_x = 17},/turf,/area)
"ar" = (/obj/Autojoin/BackgroundGrassCliff,/obj/Autojoin/GrassCliff,/turf,/area)
"as" = (/obj/Brick,/turf,/area)
"at" = (/obj/Autojoin/BackgroundGrassCliff,/turf,/area)
"au" = (/obj/Collectible/Emerald,/obj/Conveyor/Switched{dir = 8},/turf,/area)
"av" = (/obj/SwitchBlock,/turf,/area)
"aw" = (/obj/Conveyor/Switched,/turf,/area)
"ax" = (/obj/Hazard/Spikes{tag = "icon-Spikes (EAST)"; icon_state = "Spikes"; dir = 4},/turf,/area)
"ay" = (/mob/FlierVertical,/turf,/area)
"az" = (/obj/Hazard/Spikes{tag = "icon-Spikes (WEST)"; icon_state = "Spikes"; dir = 8},/turf,/area)
"aA" = (/obj/Hazard/Spikes/Acidblock,/obj/Autojoin/BackgroundGrassCliff,/turf,/area)
"aB" = (/obj/Autojoin/GrassCliff,/obj/Autojoin/BackgroundGrassCliff,/turf,/area)
"aC" = (/obj/Brick/BrickTop,/obj/Conveyor,/turf,/area)
"aD" = (/obj/Brick/BrickTop,/obj/Conveyor{dir = 8; icon_state = "Conveyor0"; tag = "icon-Conveyor0"},/turf,/area)
"aE" = (/obj/Collectible/Emerald,/obj/Autojoin/BackgroundGrassCliff,/turf,/area)
"aF" = (/obj/Brick/BrickTop,/obj/Autojoin/BackgroundGrassCliff,/turf,/area)
"aG" = (/obj/Sparkle,/obj/Autojoin/BackgroundGrassCliff,/turf,/area)
"aH" = (/obj/Brick,/obj/Autojoin/BackgroundGrassCliff,/turf,/area)
"aI" = (/obj/Platform,/mob/Crawler,/turf,/area)
"aJ" = (/obj/Water/Surface,/turf,/area)
"aK" = (/obj/Hazard/Spikes/Acidblock,/turf,/area)
"aL" = (/obj/Water,/turf,/area)
"aM" = (/obj/Water,/obj/Collectible/Emerald,/turf,/area)
"aN" = (/obj/Autojoin/GrassCliff,/obj/Water,/turf,/area)
"aO" = (/obj/Ramp/Ramp1L,/turf,/area)
"aP" = (/obj/ToggleBlock,/turf,/area)
"aQ" = (/obj/ToggleBlock{tag = "icon-On"; icon_state = "On"},/turf,/area)
"aR" = (/mob/IronCrate,/turf,/area)
"aS" = (/obj/Hazard/Spikes,/turf,/area)
"aT" = (/obj/Conveyor/Switched/Off/West{SignalChannel = "BrickBreaker"},/turf,/area)
"aU" = (/obj/Brick/Cracked,/turf,/area)
"aV" = (/obj/Spawner/LitBomb,/obj/Autojoin/BackgroundGrassCliff,/turf,/area)
"aW" = (/obj/Checkpoint,/obj/Autojoin/BackgroundGrassCliff,/turf,/area)
"aX" = (/obj/Autojoin/BackgroundGrassCliff,/obj/SwitchBlock{SignalChannel = "BrickBreaker"},/turf,/area)
"aY" = (/obj/Brick/Cracked,/obj/Autojoin/BackgroundGrassCliff,/turf,/area)
"aZ" = (/obj/Autojoin/BackgroundGrassCliff,/mob/LitBomb/Big{step_x = 0; step_y = 0},/turf,/area)
"ba" = (/obj/Ramp/Ramp1R,/obj/Autojoin/BackgroundGrassCliff,/turf,/area)
"bb" = (/obj/Autojoin/BackgroundGrassCliff,/obj/PlayerStart,/turf,/area)
"bc" = (/mob/FlierHorizontal,/turf,/area)
"bd" = (/obj/Conveyor,/turf,/area)
"be" = (/obj/Hazard/Spikes,/obj/Autojoin/BackgroundGrassCliff,/turf,/area)

(1,1,1) = {"
aaaaaaaaaaaaaaaaaaaaaaaaaaaaaaaaaaaaaaaaaaaaaaaaaaaaaaaaaaaaaaaaaaaaaaaaaaaaaaaaaaaaaaaaaaaaababababaaaaaaaaaaaaaaaaaaaa
aaaaaaaaaaaaaaaaaaababaaaaaaaaaaaaaaaaaaaaaaaaaaaaaaaaaaaaaaaaaaaaaaaaaaaaaaaaaaaaaaaaaaaaaaacaaababaaaaaaaaaaaaaaaaaaaa
aaaaaaaaaaaaaaaaaaababaaaaaaabaaaaaaaaaaaaaaaaadaaaeaaaaafaaaaaaaaaaaaaaaaaaaaaaaaaaaaaaaaaaabaaababaaaaaaaaaaaaaaaaaaaa
aaaaaaaaaaaaaaabababababababababababaaaaaaaaaaaaagagagagaaaaaaaaaaaaaaaaaaaaaaaaaaaaaaaaaaaaabahababaaaaaaaaaaaaaaaaaaaa
aaaaaaaaaaabaaaaaaababaaaaaaaaaaabaaaaaaaaaaaaaaaaaaaaaaaaaaaaaaaaaiaaaaaaaaaaaaaaaaaaaaaaaaabajababaaaaaaaaaaaaaaaaaaaa
aaaaaaaaaaabaaaaaaababaaaaaaaaaaaaaaaaaaaaaaaaaaaaaaaaaaakaaaaaaaaaaaaaaaaaaaaaaaaaaaaaaaaaaabaaababaaaaaaaaaaaaaaaaaaaa
aaaaaaababababababababababaaaaaaaaaaaaaaaaaaaaaaaaaaaaaaaaaaaaaaaaaaaaaaaaaaaaaaaaaaaaaaaaaaabajababaaaaaaaaaaaaaaaaaaaa
aaaaaaababababababababababaaaaaaalalalalaaaaaaamaaamaaalalalaaaaaaaaaaaaaaaaaaaaaaaaaaaaaaaaabaaababaaaaaaaaaaaaaaaaaaaa
aaaaaaaaaaabaaaaaaababaaaaaaaaaaaaaaaaaaaaaaaaaaaaaaaaaaaaaaaaaaaaaaaaaaaaaaaaaaaaaaaaaaaaaaabajababaaaaaaaaaaaaaaaaaaaa
aaaaaaaaaaabaaaaaaababaaaaaaaaaaaaaaaaaaaaaaaaaaaaaaaaaaaaaaaaaaalalajalaaaaaaaaaaaaaaaaaaaaabaaababaaaaaaaaaaaaaaaaaaaa
aaaaaaaaaaaaaaaaaaaaaaaaaaaaaaaaaaaaaaaaaaakakaaaaaaaaaaaaaaaaaaaaaaajaaaaaaaaaaaaaaaaaaaaanabajababaaaaaaaaaaaaaaaaaaaa
aaaaaaababababababaaaaaaaaakaaaaaaaaaaaaaaaaaoaaaaaaaaaaaaaaaaaaaaaaaaaaaaaaaaaaaaaaanababababaaababaaaaaaaaaaaaaaaaaaaa
aaaaaaaaaaababababaaaaaaaaaaaaaaaaaaaaaaapapapapaqaaaaaaaaaaaaaaapapapapaaaaaaaaaaanabababababajababaaaaaaaaaaaaaaaaaaaa
aaaaaaaaaaabararabaaaaaaabababaaaaaaaaaaaaaaaaaaaaaaasaeasaaaaaaaaaaaaaaaaaaaaaaaaababababababaaababaaaaaaaaaaaaaaaaaaaa
aaaaaaaaaaaaatataaaaaaaaabababajaaaaaaaaaaakaaaaaaauasavasawakaaaaaaakaaaaaaaaaaaaababababababajababaaaaaaaaaaaaaaaaaaaa
aaaaaaaaaaaaatataaaaaaaaabaxaaaaaaaaakaaaaaaaaaaaaaaaaaaaaaaaaaaaaaaaaaaaaakaaayaaaaazababababaaababaaaaaaaaaaaaaaaaaaaa
aAaAaAaAaAaAaAaAaAaAaAaAabaxaaaaaaaaaaaaaaaaaaaaaaaaaaaaaaaaaaaaaaaaaaaaaaaaaaaaaaaaazababababajababaaaaaaaaaaaaaaaaaaaa
aBatatatatatatatataBaBaBababababababababaaaaaaaaaCaCaCahahaDaDaDaaaaaaaaabababababababababababaaababaaaaaaaaaaaaaaaaaaaa
aBatatataEatataFatatatataaaaaaaaaaaaaaaaaaaaaaaaaaaaaaahahaaaaaaaaaaaaaaaaaaaaaaaaababababababajababaaaaaaaaaaaaaaaaaaaa
aBatatatatataGaHataEaEaEakaoaaaaaaaaaaaaaaaaabaaaaakaaahaIaaakaaaaabaJaJaJaJaJaJaJababababababaaababaaaaaaaaaaaaaaaaaaaa
aBataEatatatataHaFaFaFaFalalaaaaaaaaaaaaaaaaabaKaKaKaKaKaKaKaKaKaKabaLaLaLaLaLaLaLababababababajababaaaaaaaaaaaaaaaaaaaa
aBatataGatatatatatatatataaasaaaaaaaaaaaaaaaaabaaaaaaaaaaaaaaaaaaaaabaLaMaLaLaLaMaLababababababaaababaaaaaaaaaaaaaaaaaaaa
aBatatatatatatatataFaFaFalasaaaaaaaaaaaaaaajabaaaaaaababaJaNabababaNaLaLaLaMaLaLaLababababababajababaaaaaaaaaaaaaaaaaaaa
aBaEatataGatatatatatatataaaaaaaaaaaaaaaaaaaaabaaaaaaababaLaLaLaLaLaLaLaLaLaLaLaLaLababababababaaababaaaaaaaaaaaaaaaaaaaa
aBaGatatatataEatataBaBaBaOaaaaaaaaaaaaaaaaaaabaaaaaaababababababababababababababababaaaaaaababajababaaaaaaaaaaaaaaaaaaaa
aBatatatatatatatatatataBabaOaaaaaaaaaaaaaaaaabaaaaabababaaavaaaaavaaaaaaaaaaaaaaaaaPaaavaaababaaababaaaaaaaaaaaaaaaaaaaa
aBatataGatatataGatatataBababaOaaaoaaaaaaaaababaaaaabababaaaaaaaaaaaaaaaaaaaaaaaaaaaPaaaaaaabaBaGaBabaaaaaaaaaaaaaaaaaaaa
aBatatatatatatatatatataBabababababababababababaaaaaaaaaaaaaaaaaaaaaaaaaaaaaaaaaaaaaPaaaaaaabaBataBabaaaaaaaaaaaaaaaaaaaa
aBaAaAaAaAaAaAaAaAaAaAaBabababababababababababababababaQaQaaaPaPaaaQaQabababababababaQaQaQabaBaGaBababababababababaaaaaa
abababababababababababababababaaaaaRabababababababababaaaaaaaaaaaaaaaaabaBaBaBaBaBaBatatataBaBataBaBaBaBaBaBaBababaaaaaa
abababababababababababababababaaaaaRabababababababababaSaSaSaSaSaSaSaSabaBaBaBaBaBaBatatatatataGatatatatatataBababaaaaaa
aaaaaaaaaaaaaaaaaaaaaaaaababaaaaaTaTababaBaBaBaBaBaBabababakaaakaaaUaaaaatatataVatatatatatatataGatatatatatataBababaaaaaa
aaaaaaaaaaaaaaaaaaaaaaaaababaaaaaaaaaaaaatatatatataBabababaaakaaakaUaaaaatatatatatatataWatatatatatatatatatataBababaaaaaa
aaaaaaaaaaaaaaaaaaaaaaaaababaaaaaaaaaaaaatatatatataBababababababababababaBaBaBaBaBaBaBaBaBaBaBaBaBatatatatataBababaaaaaa
aaaaaaaaaaaaaaaaaaaaaaaaababaaaaaaaaaaaaaXatatatataBaBaBaBaBaBaBaBaBabababababababababababababaBaYatatatatataBababaaaaaa
aaaaaaaaaaaaaaaaaaaaaaaaababaaaaaaaaaaaaatatatatatatatatatatatatatataaaaaaaaaaaaaaaaaaaaaaaaakataYaZatatatbaaBababaaaaaa
aaaaaaaaaaaaaaaaaaaaaaababababaaaaaaaaaaatatatatatatbbatatatatatatataaaaaaaaaaaaaaaaaaaaaaaaabaBaBaBaBaBaBaBaBababaaaaaa
aaaaaaaaaaaaaaaaaaaaaaababababaaaaaaaaaaaBaBaBaBaBaBaBaBaBaBaBaBaBaBabaOaaaaaaaaaaaaaaaaaaaaabababababababababababaaaaaa
aaaaaaaaaaaaaaaaaaaaaaaaaaaaaaagaaaaaaababababaBaBababaBaBababaBaBabababaabcaaaaaaaaaaaaaaaaaaaaaaaaaaaaaaaaaaaaaaaaaaaa
aaaaaaaaaaaaaaaaaaaaabababababaaababababababaaatataaaaatataaaaatataaababaaaaaaaaaaaaaaaaaaaaaaaaaaaaaaaaaaaaaaaaaaaaaaaa
aaaaaaaaaaaaaaaaaaaaabababababaaababababababaaatataaaaatataaaaatataaaaaaaaaaaaaaaaaaaaaaaaaaaaaaaaaaaaaaaaaaaaaaaaaaaaaa
aaaaaaaaaaaaaaaaaaaaabababababaSababababaaaaaaatataaaaatataaaaatataaaaaaaaaaaaaaaaaaaaaaaaaaaaaaaaaaaaaaaaaaaaaaaaaaaaaa
aaaaaaaaaaaaaaaaaaaaabaBaBaBabababaBabaaaaaaaaatataaaaatataaaaatataaaaaaaaaaaaaaaaaaaaaaaaaaaaaaaaaaaaaaaaaaaaaaaaaaaaaa
aaaaaaaaaaaaaaaaaaaaaaatatatatatatataaaaaaaaaaatatatatatataaaaatataaaaaaaaaaaaaaaaaaaaaaaaaaaaaaaaaaaaaaaaaaaaaaaaaaaaaa
aaaaaaaaaaaaaaaaaaaaaaatatatatatatataaaaaaaaaaatatatatatataaaaatataaaaaaaaaaaaaaaaaaaaaaaaaaaaaaaaaaaaaaaaaaaaaaaaaaaaaa
aaaaaaaaaaaaaaaaaaaaaaatatatatatatataaaaaaaaaaatataaaaaaaaaaaaatataaaaaaaaaaaaaaaaaaaaaaaaaaaaaaaaaaaaaaaaaaaaaaaaaaaaaa
aaaaaaaaaaaaaaaaaaaaaaatatatatatatataaaaaaaaaaatataaaaaaaaaaaaatataaaaaaaaaaaaaaaaaaaaaaaaaaaaaaaaaaaaaaaaaaaaaaaaaaaaaa
aaaaaaaaaaaaaaaaaaaaaaatataaaaaaatataaaaaaaaaaatataaaaaaaaaaaaatataaaaaaaaaaaaaaaaaaaaaaaaaaaaaaaaaaaaaaaaaaaaaaaaaaaaaa
aaaaaaaaaaaaaaaaaaaaaaatataaaaaaatataaaaaaaaaaatataaaaaaaaaaaaatataaaaaaaaaaaaaaaaaaaaaaaaaaaaaaaaaaaaaaaaaaaaaaaaaaaaaa
aabdbdbdaaaaaaaaaaaaaaatataaaaaaatataaaaaaaaaaatataaaaaaaaaaaaatataaaaaaaaaaaaaaaaaaaaaaaaaaaaaaaaaaaaaaaaaaaaaaaaaaaaaa
aaawawawaaaaaaaaaaaaaaatatatatatatataaaaaaaaaaatataaaaaaaaaaaaatataaaaaaaaaaaaaaaaaaaaaaaaaaaaaaaaaaaaaaaaaaaaaaaaaaaaaa
aaaaaaaaaaaaaaaaaaaaaaatatatatatatataaaaaaaaaaatataaaaaaaaaaaaatataaaaaaaaaaaaaaaaaaaaaaaaaaaaaaaaaaaaaaaaaaaaaaaaaaaaaa
aaaaaaaaaaaaaaaaaaaaaaatatatatatatataaaaaaaaaaatataaaaaaaaaaaaatataaaaaaaaaaaaaaaaaaaaaaaaaaaaaaaaaaaaaaaaaaaaaaaaaaaaaa
aaaaaaaaaaaaaaaaaaaaaaatatatatatatataaaaaaaaaaatataaaaaaaaaaaaatataaaaaaaaaaaaaaaaaaaaaaaaaaaaaaaaaaaaaaaaaaaaaaaaaaaaaa
aaaaaaaaaaaaaaaaaaaaaaatatatatatatataaaaaaaaaaatataaaaaaaaaaaaatataaaaaaaaaaaaaaaaaaaaaaaaaaaaaaaaaaaaaaaaaaaaaaaaaaaaaa
aaaaaaaaaaaaaaaaaaaaaaatatatatatatataaaaaaaaaaatataaaaaaaaaaaaatataaaaaaaaaaaaaaaaaaaaaaaaaaaaaaaaaaaaaaaaaaaaaaaaaaaaaa
aaaaaaaaaaaaaaaaaaaaaaatatatatatatataaaaaaaaaaatataaaaaaaaaaaaatataaaaaaaaaaaaaaaaaaaaaaaaaaaaaaaaaaaaaaaaaaaaaaaaaaaaaa
aaaaaaaaaaaaaaaaaaaaaaatatatatatatataaaaaaaaaaatataaaaaaaaaaaaatataaaaaaaaaaaaaaaaaaaaaaaaaaaaaaaaaaaaaaaaaaaaaaaaaaaaaa
aaaaaaaaaaaaaaaaaaaaaaatatatatatatataaaaaaaaaaatataaaaaaaaaaaaatataaaaaaaaaaaaaaaaaaaaaaaaaaaaaaaaaaaaaaaaaaaaaaaaaaaaaa
aSaSaSaSaSaSaSaSaSaSaSbebebebebebebeaSaSaSaSaSbebeaSaSaSaSaSaSbebeaSaSaSaSaSaSaSaSaSaSaSaSaSaSaSaSaSaSaSaSaSaSaSaSaSaSaS
"}
