"aa" = (/turf,/area)
"ab" = (/obj/Autojoin/GrassCliff,/turf,/area)
"ac" = (/obj/OneWayBlock{tag = "icon-OneWay (WEST)"; icon_state = "OneWay"; dir = 8},/turf,/area)
"ad" = (/obj/OneWayBlock/MobHint{tag = "icon-OneWay (EAST)"; icon_state = "OneWay"; dir = 4},/turf,/area)
"ae" = (/mob/Crawler,/turf,/area)
"af" = (/obj/OneWayBlock/MobHint{tag = "icon-OneWay (WEST)"; icon_state = "OneWay"; dir = 8},/turf,/area)
"ag" = (/obj/WoodBlock,/turf,/area)
"ah" = (/obj/Platform,/turf,/area)
"ai" = (/mob/Eagle,/turf,/area)
"aj" = (/obj/Sparkle,/turf,/area)
"ak" = (/obj/Collectible/Emerald,/turf,/area)
"al" = (/mob/PlatformWalker,/turf,/area)
"am" = (/obj/Brick/BrickTop,/turf,/area)
"an" = (/obj/GooBlock,/turf,/area)
"ao" = (/obj/Decorative/Grass,/turf,/area)
"ap" = (/obj/Ramp/Ramp1R,/turf,/area)
"aq" = (/obj/Checkpoint,/turf,/area)
"ar" = (/obj/Hazard/Spikes{tag = "icon-Spikes"; icon_state = "Spikes"; dir = 2},/turf,/area)
"as" = (/mob/FlierHorizontal{step_x = 17},/turf,/area)
"at" = (/obj/Autojoin/BackgroundGrassCliff,/obj/Autojoin/GrassCliff,/turf,/area)
"au" = (/obj/Brick,/turf,/area)
"av" = (/obj/Autojoin/BackgroundGrassCliff,/turf,/area)
"aw" = (/obj/Collectible/Emerald,/obj/Conveyor/Switched{dir = 8},/turf,/area)
"ax" = (/obj/SwitchBlock,/turf,/area)
"ay" = (/obj/Conveyor/Switched,/turf,/area)
"az" = (/obj/Hazard/Spikes{tag = "icon-Spikes (EAST)"; icon_state = "Spikes"; dir = 4},/turf,/area)
"aA" = (/obj/PlayerStart,/turf,/area)
"aB" = (/mob/FlierVertical,/turf,/area)
"aC" = (/obj/Hazard/Spikes{tag = "icon-Spikes (WEST)"; icon_state = "Spikes"; dir = 8},/turf,/area)
"aD" = (/obj/Hazard/Spikes/Acidblock,/obj/Autojoin/BackgroundGrassCliff,/turf,/area)
"aE" = (/obj/Autojoin/GrassCliff,/obj/Autojoin/BackgroundGrassCliff,/turf,/area)
"aF" = (/obj/Brick/BrickTop,/obj/Conveyor,/turf,/area)
"aG" = (/obj/Brick/BrickTop,/obj/Conveyor{dir = 8; icon_state = "Conveyor0"; tag = "icon-Conveyor0"},/turf,/area)
"aH" = (/obj/Collectible/Emerald,/obj/Autojoin/BackgroundGrassCliff,/turf,/area)
"aI" = (/obj/Brick/BrickTop,/obj/Autojoin/BackgroundGrassCliff,/turf,/area)
"aJ" = (/obj/Sparkle,/obj/Autojoin/BackgroundGrassCliff,/turf,/area)
"aK" = (/obj/Brick,/obj/Autojoin/BackgroundGrassCliff,/turf,/area)
"aL" = (/obj/Platform,/mob/Crawler,/turf,/area)
"aM" = (/obj/Water/Surface,/turf,/area)
"aN" = (/obj/Hazard/Spikes/Acidblock,/turf,/area)
"aO" = (/obj/Water,/turf,/area)
"aP" = (/obj/Water,/obj/Collectible/Emerald,/turf,/area)
"aQ" = (/obj/Autojoin/GrassCliff,/obj/Water,/turf,/area)
"aR" = (/obj/Ramp/Ramp1L,/turf,/area)
"aS" = (/obj/ToggleBlock,/turf,/area)
"aT" = (/obj/Decorative/Mushroom/Small,/turf,/area)
"aU" = (/obj/ToggleBlock{tag = "icon-On"; icon_state = "On"},/turf,/area)
"aV" = (/mob/IronCrate,/turf,/area)
"aW" = (/obj/Hazard/Spikes,/turf,/area)
"aX" = (/obj/Conveyor/Switched/Off/West{SignalChannel = "BrickBreaker"},/turf,/area)
"aY" = (/obj/Brick/Cracked/Stone,/turf,/area)
"aZ" = (/obj/Spawner/LitBomb,/obj/Autojoin/BackgroundGrassCliff,/turf,/area)
"ba" = (/obj/Autojoin/BackgroundGrassCliff,/obj/Decorative/Mushroom/Small,/turf,/area)
"bb" = (/obj/Checkpoint,/obj/Autojoin/BackgroundGrassCliff,/turf,/area)
"bc" = (/obj/Autojoin/BackgroundGrassCliff,/obj/Decorative/Mushroom,/turf,/area)
"bd" = (/obj/Autojoin/BackgroundGrassCliff,/obj/SwitchBlock{SignalChannel = "BrickBreaker"},/turf,/area)
"be" = (/obj/Autojoin/BackgroundGrassCliff,/obj/Brick/Cracked/Stone,/turf,/area)
"bf" = (/obj/Autojoin/BackgroundGrassCliff,/mob/LitBomb/Big{step_x = 0; step_y = 0},/turf,/area)
"bg" = (/obj/Ramp/Ramp1R,/obj/Autojoin/BackgroundGrassCliff,/turf,/area)
"bh" = (/mob/FlierHorizontal,/turf,/area)
"bi" = (/obj/Conveyor,/turf,/area)
"bj" = (/obj/Hazard/Spikes,/obj/Autojoin/BackgroundGrassCliff,/turf,/area)

(1,1,1) = {"
aaaaaaaaaaaaaaaaaaaaaaaaaaaaaaaaaaaaaaaaaaaaaaaaaaaaaaaaaaaaaaaaaaaaaaaaaaaaaaaaaaaaaaaaaaaaababababaaaaaaaaaaaaaaaaaaaa
aaaaaaaaaaaaaaaaaaababaaaaaaaaaaaaaaaaaaaaaaaaaaaaaaaaaaaaaaaaaaaaaaaaaaaaaaaaaaaaaaaaaaaaaaacaaababaaaaaaaaaaaaaaaaaaaa
aaaaaaaaaaaaaaaaaaababaaaaaaabaaaaaaaaaaaaaaaaadaaaeaaaaafaaaaaaaaaaaaaaaaaaaaaaaaaaaaaaaaaaabaaababaaaaaaaaaaaaaaaaaaaa
aaaaaaaaaaaaaaabababababababababababaaaaaaaaaaaaagagagagaaaaaaaaaaaaaaaaaaaaaaaaaaaaaaaaaaaaabahababaaaaaaaaaaaaaaaaaaaa
aaaaaaaaaaabaaaaaaababaaaaaaaaaaabaaaaaaaaaaaaaaaaaaaaaaaaaaaaaaaaaiaaaaaaaaaaaaaaaaaaaaaaaaabajababaaaaaaaaaaaaaaaaaaaa
aaaaaaaaaaabaaaaaaababaaaaaaaaaaaaaaaaaaaaaaaaaaaaaaaaaaakaaaaaaaaaaaaaaaaaaaaaaaaaaaaaaaaaaabaaababaaaaaaaaaaaaaaaaaaaa
aaaaaaababababababababababaaaaaaaaaaalaaaaaaaaaaaaaaaaaaalaaaaaaaaaaaaaaaaaaaaaaaaaaaaaaaaaaabajababaaaaaaaaaaaaaaaaaaaa
aaaaaaababababababababababaaaaaaamamamamaaaaaaanaaanaaamamamaaaaaaaaaaaaaaaaaaaaaaaaaaaaaaaaabaaababaaaaaaaaaaaaaaaaaaaa
aaaaaaaaaaabaaaaaaababaaaaaaaaaaaaaaaaaaaaaaaaaaaaaaaaaaaaaaaaaaaaaaaaaaaaaaaaaaaaaaaaaaaaaaabajababaaaaaaaaaaaaaaaaaaaa
aaaaaaaaaaabaaaaaaababaaaaaaaaaaaaaaaaaaaaaaaaaaaaaaaaaaaaaaaaaaamamajamaaaaaaaaaaaaaaaaaaaaabaaababaaaaaaaaaaaaaaaaaaaa
aaaaaaaaaaaoaoaoaaaaaaaaaaaaaaaaaaaaaaaaaaakakaaaaaaaaaaaaaaaaaaaaaaajaaaaaaaaaaaaaaaaaaaaapabajababaaaaaaaaaaaaaaaaaaaa
aaaaaaababababababaaaaaaaaakaaaaaaaaaaaaalaaaqaaaaaaaaaaaaaaaaaaaaaaaaaaaaaaaaaaaaaaapababababaaababaaaaaaaaaaaaaaaaaaaa
aaaaaaaaaaababababaaaaaaaaalaaaaaaaaaaaaararararasaaaaaaaaaaaaaaararararaaaaaaaaaaapabababababajababaaaaaaaaaaaaaaaaaaaa
aaaaaaaaaaabatatabaaaaaaabababaaaaaaaaaaaaaaaaaaaaaaauaeauaaaaaaaaaaaaaaaaaaaaaaaaababababababaaababaaaaaaaaaaaaaaaaaaaa
aaaaaaaaaaaaavavaaaaaaaaabababajaaaaaaaaaaakaaaaaaawauaxauayakaaaaaaakaaaaaaaaaaaaababababababajababaaaaaaaaaaaaaaaaaaaa
aaaaaaaaaaaaavavaaaaaaaaabazaaaaaAaaakaaaaaaaaaaaaaaaaaaaaaaaaaaaaaaaaaaaaakaaaBaaaaaCababababaaababaaaaaaaaaaaaaaaaaaaa
aDaDaDaDaDaDaDaDaDaDaDaDabazaoaoaaaoaaaaaaaaaaaaalaaaaaaaaaaaaaaaaaaaaaaaaaaalaaaaaaaCababababajababaaaaaaaaaaaaaaaaaaaa
aEavavavavavavavavaEaEaEababababababababaaaaaaaaaFaFaFahahaGaGaGaaaaaaaaabababababababababababaaababaaaaaaaaaaaaaaaaaaaa
aEavavavaHavavaIavavavavaaaaaaaaaaaaaaaaaaaaalaaaaaaaaahahaaaaaaaaaaaaaaaaaaaaaaaaababababababajababaaaaaaaaaaaaaaaaaaaa
aEavavavavavaJaKavaHaHaHakaqaaaaaaaaaaaaaaaaabaaaaakaaahaLaaakaaaaabaMaMaMaMaMaMaMababababababaaababaaaaaaaaaaaaaaaaaaaa
aEavaHavavavavaKaIaIaIaIamamaaaaaaaaaaaaaaaaabaNaNaNaNaNaNaNaNaNaNabaOaOaOaOaOaOaOababababababajababaaaaaaaaaaaaaaaaaaaa
aEavavaJavavavavavavavavaaauaaaaaaaaaaaaaaaaabaaaaaaaaaaaaaaaaaaaaabaOaPaOaOaOaPaOababababababaaababaaaaaaaaaaaaaaaaaaaa
aEavavavavavavavavaIaIaIamauaaaaaaaaaaaaaaajabaaaaaaababaMaQabababaQaOaOaOaPaOaOaOababababababajababaaaaaaaaaaaaaaaaaaaa
aEaHavavaJavavavavavavavaaaaaaaaaaaaaaaaaaaaabaaaaaaababaOaOaOaOaOaOaOaOaOaOaOaOaOababababababaaababaaaaaaaaaaaaaaaaaaaa
aEaJavavavavaHavavaEaEaEaRaaaaaaaaaaaaaaaaaaabaaaaaaababababababababababababababababaaaaaaababajababaaaaaaaaaaaaaaaaaaaa
aEavavavavavavavavavavaEabaRaaaaaaaaaaaaaaaaabaaaaabababaaaxaaaaaxaaaaaaaaaaaaaaaaaSaaaxaaababaaababaaaaaaaaaaaaaaaaaaaa
aEavavaJavavavaJavavavaEababaRaaaqaaaaaaaaababaaaaabababaaaaaaaaaaaaaaaaaaaaaaaaaaaSaaaaaaabaEaJaEabaaaaaaaaaaaaaaaaaaaa
aEavavavavavavavavavavaEabababababababababababaaaaaaaaaaaaaaaaaaaaaaaaaaaaaTaaaaaaaSaaaaaaabaEavaEabaaaaaaaaaaaaaaaaaaaa
aEaDaDaDaDaDaDaDaDaDaDaEabababababababababababababababaUaUaaaSaSaaaUaUabababababababaUaUaUabaEaJaEababababababababaaaaaa
abababababababababababababababaaaaaVabababababababababaaaaaaaaaaaaaaaaabaEaEaEaEaEaEavavavaEaEavaEaEaEaEaEaEaEababaaaaaa
abababababababababababababababaaaaaVabababababababababaWaWaWaWaWaWaWaWabaEaEaEaEaEaEavavavavavaJavavavavavavaEababaaaaaa
aaaaaaaaaaaaaaaaaaaaaaaaababaaaaaXaXababaEaEaEaEaEaEabababakaaakaaaYaaaaavavavaZavavavavavavavaJavavavavavavaEababaaaaaa
aaaaaaaaaaaaaaaaaaaaaaaaababaaaaaaaaaaaaavavavavavaEabababaaakaaakaYaaaTavavavavbaavavbbbabcavavavavavavavavaEababaaaaaa
aaaaaaaaaaaaaaaaaaaaaaaaababaaaaaaaaaaaaavavavavavaEababababababababababaEaEaEaEaEaEaEaEaEaEaEaEaEavavavavavaEababaaaaaa
aaaaaaaaaaaaaaaaaaaaaaaaababaaaaaaaaaaaabdavavavavaEaEaEaEaEaEaEaEaEababababababaEaEabababababaEbeavavavavavaEababaaaaaa
aaaaaaaaaaaaaaaaaaaaaaaaababaaaaaaaaaaaaavavavavavavavavavavavavavavaaaaaaaaaaaaavavaaaaaaaaakavbebfavbcavbgaEababaaaaaa
aaaaaaaaaaaaaaaaaaaaaaababababaaaaaaaaaaavavavavavavavavavavavavavavaaaaaaaaaaaaavavaaaaaaaaabaEaEaEaEaEaEaEaEababaaaaaa
aaaaaaaaaaaaaaaaaaaaaaababababaaaaaaaaaaaEaEaEaEaEaEaEaEaEaEaEaEaEaEabaRaaaaaaaaavavaaaaaaaaabababaEaEababababababaaaaaa
aaaaaaaaaaaaaaaaaaaaaaaaaaaaaaagaaaaaaababababaEaEababaEaEababaEaEabababaabhaaaaavavaaaaaaaaaaaaaaavavaaaaaaaaaaaaaaaaaa
aaaaaaaaaaaaaaaaaaaaabababababaaababababababaaavavaaaaavavaaaaavavaaababaaaaaaaaavavaaaaaaaaaaaaaaavavaaaaaaaaaaaaaaaaaa
aaaaaaaaaaaaaaaaaaaaabababababaaababababababaaavavaaaaavavaaaaavavaaaaaaaaaaaaaaavavaaaaaaaaaaaaaaavavaaaaaaaaaaaaaaaaaa
aaaaaaaaaaaaaaaaaaaaabababababaWababababaaaaaaavavaaaaavavaaaaavavaaaaaaaaaaaaaaavavaaaaaaaaaaaaaaavavaaaaaaaaaaaaaaaaaa
aaaaaaaaaaaaaaaaaaaaabaEaEaEabababaEabaaaaaaaaavavaaaaavavaaaaavavaaaaaaaaaaaaaaavavaaaaaaaaaaaaaaavavaaaaaaaaaaaaaaaaaa
aaaaaaaaaaaaaaaaaaaaaaavavavavavavavaaaaaaaaaaavavavavavavaaaaavavaaaaaaaaaaaaaaavavavavavavavavavavavaaaaaaaaaaaaaaaaaa
aaaaaaaaaaaaaaaaaaaaaaavavavavavavavaaaaaaaaaaavavavavavavaaaaavavaaaaaaaaaaaaaaavavavavavavavavavavavaaaaaaaaaaaaaaaaaa
aaaaaaaaaaaaaaaaaaaaaaavavavavavavavaaaaaaaaaaavavaaaaaaaaaaaaavavaaaaaaaaaaaaaaaaaaaaaaaaavavaaaaaaaaaaaaaaaaaaaaaaaaaa
aaaaaaaaaaaaaaaaaaaaaaavavavavavavavaaaaaaaaaaavavaaaaaaaaaaaaavavavavavavavaaaaaaaaaaaaaaavavaaaaaaaaaaaaaaaaaaaaaaaaaa
aaaaaaaaaaaaaaaaaaaaaaavavaaaaaaavavaaaaaaaaaaavavaaaaaaaaaaaaavavavavavavavaaaaaaaaaaaaaaavavaaaaaaaaaaaaaaaaaaaaaaaaaa
aaaaaaaaaaaaaaaaaaaaaaavavaaaaaaavavaaaaaaaaaaavavaaaaaaaaaaaaavavaaaaaaavavaaaaaaaaaaaaaaavavaaaaaaaaaaaaaaaaaaaaaaaaaa
aabibibiaaaaaaaaaaaaaaavavaaaaaaavavaaaaaaaaaaavavaaaaaaaaaaaaavavaaaaaaavavavavavavavavavavavaaaaaaaaaaaaaaaaaaaaaaaaaa
aaayayayaaaaaaaaaaaaaaavavavavavavavaaaaaaaaaaavavaaaaaaaaaaaaavavaaaaaaavavavavavavavavavavavaaaaaaaaaaaaaaaaaaaaaaaaaa
aaaaaaaaaaaaaaaaaaaaaaavavavavavavavaaaaaaaaaaavavaaaaaaaaaaaaavavaaaaaaaaaaaaaaaaaaaaaaaaaaaaaaaaaaaaaaaaaaaaaaaaaaaaaa
aaaaaaaaaaaaaaaaaaaaaaavavavavavavavaaaaaaaaaaavavaaaaaaaaaaaaavavaaaaaaaaaaaaaaaaaaaaaaaaaaaaaaaaaaaaaaaaaaaaaaaaaaaaaa
aaaaaaaaaaaaaaaaaaaaaaavavavavavavavaaaaaaaaaaavavaaaaaaaaaaaaavavaaaaaaaaaaaaaaaaaaaaaaaaaaaaaaaaaaaaaaaaaaaaaaaaaaaaaa
aaaaaaaaaaaaaaaaaaaaaaavavavavavavavaaaaaaaaaaavavaaaaaaaaaaaaavavaaaaaaaaaaaaaaaaaaaaaaaaaaaaaaaaaaaaaaaaaaaaaaaaaaaaaa
aaaaaaaaaaaaaaaaaaaaaaavavavavavavavaaaaaaaaaaavavaaaaaaaaaaaaavavaaaaaaaaaaaaaaaaaaaaaaaaaaaaaaaaaaaaaaaaaaaaaaaaaaaaaa
aaaaaaaaaaaaaaaaaaaaaaavavavavavavavaaaaaaaaaaavavaaaaaaaaaaaaavavaaaaaaaaaaaaaaaaaaaaaaaaaaaaaaaaaaaaaaaaaaaaaaaaaaaaaa
aaaaaaaaaaaaaaaaaaaaaaavavavavavavavaaaaaaaaaaavavaaaaaaaaaaaaavavaaaaaaaaaaaaaaaaaaaaaaaaaaaaaaaaaaaaaaaaaaaaaaaaaaaaaa
aaaaaaaaaaaaaaaaaaaaaaavavavavavavavaaaaaaaaaaavavaaaaaaaaaaaaavavaaaaaaaaaaaaaaaaaaaaaaaaaaaaaaaaaaaaaaaaaaaaaaaaaaaaaa
aWaWaWaWaWaWaWaWaWaWaWbjbjbjbjbjbjbjaWaWaWaWaWbjbjaWaWaWaWaWaWbjbjaWaWaWaWaWaWaWaWaWaWaWaWaWaWaWaWaWaWaWaWaWaWaWaWaWaWaW
"}
