"a" = (/turf,/area)
"b" = (/mob/Eagle,/turf,/area)
"c" = (/obj/BrickTop,/turf,/area)
"d" = (/obj/Sparkle,/turf,/area)
"e" = (/obj/Collectible/Emerald,/turf,/area)
"f" = (/obj/Checkpoint,/turf,/area)
"g" = (/mob/FlierHorizontal{step_x = 17},/turf,/area)
"h" = (/obj/Brick,/turf,/area)
"i" = (/obj/Hazard/Spikes{tag = "icon-Spikes"; icon_state = "Spikes"; dir = 2},/turf,/area)
"j" = (/obj/Hazard/Spikes{tag = "icon-Spikes (EAST)"; icon_state = "Spikes"; dir = 4},/turf,/area)
"k" = (/mob/FlierVertical,/turf,/area)
"l" = (/obj/Hazard/Spikes{tag = "icon-Spikes (WEST)"; icon_state = "Spikes"; dir = 8},/turf,/area)
"m" = (/obj/Hazard/Spikes/Acidblock,/turf,/area)
"n" = (/obj/PlayerStart,/turf,/area)
"o" = (/obj/Platform,/turf,/area)
"p" = (/obj/Platform,/mob/Crawler,/turf,/area)
"q" = (/obj/Water/Surface,/turf,/area)
"r" = (/obj/Water,/turf,/area)
"s" = (/obj/Water,/obj/Collectible/Emerald,/turf,/area)
"t" = (/obj/SwitchBlock,/turf,/area)
"u" = (/obj/ToggleBlock,/turf,/area)
"v" = (/obj/BrickTop{step_x = 0},/turf,/area)
"w" = (/obj/ToggleBlock{tag = "icon-On"; icon_state = "On"},/turf,/area)
"x" = (/obj/BrickTop{step_x = 1},/turf,/area)
"y" = (/obj/Hazard/Spikes,/turf,/area)

(1,1,1) = {"
aaaaaaaaaaaaaaaaaaaaaaaaaaaaaaaaaaaaaaaaaaaaaaaaaaaaaaaaaaaa
aaaaaaaaaaaaaaaaaaaaaaaaaaaaaaaaaaaaaaaaaaaaaaaaaaaaaaaaaaaa
aaaaaaaaaaaaaaaaaaaaaaaaaaaaaaaaaaaaaaaaaaaaaaaaaaaaaaaaaaaa
aaaaaaaaaaaaaaaaaaaaaaaaaaaaaaaaaaaaaaaaaaaaaaaaaaaaaaaaaaaa
aaaaaaaaaaaaaaaaaaaaaaaaaaaaaaaaaaaaaaaaaaaaaaaaaaaaaaaaaaaa
aaaaaaaaaaaaaaaaaaaaaaaaaaaaaabaaaaaaaaaaaaaaaaaaaaaaaaaaaaa
aaaaaaaaaaaaaaaaaaaaaaaaaaaaaaaaaaaaaaaaaaaaaaaaaaaaaaaaaaaa
aaaaaaaaaaaaaaaaaaaaaaaaaaaaaaaaaaaaaaaaaaaaaaaaaaaaaaaaaaaa
aaaaaaaaaaaaaaaaaaaaaaaaaaaaaaaaaaaaaaaaaaaaaaaaaaaaaaaaaaaa
aaaaaaaaaaaaaaaaaaaaaaaaaaaaaaaaaaaaaaaaaaaaaaaaaaaaaaaaaaaa
aaaaaaaaaaaaaaaaaaaaaaaaaaaaaaaaccdcaaaaaaaaaaaaaaaaaaaaaaaa
aaaaaaaaaaaaaeaaaaaaaeeaaaaaaaaaaadaaaaaaaecaaaaaaaaaaaaaaaa
aaaaaaaaaaaaaaaaaaaaaafagaaaaaaaaaaaaaaaaachaaaaaaaaaaaaaaaa
aaaaaaaaaaaacccaaaaaiiiiaaaaaaaaiiiiaaaaachhaaaaaaaaaaaaaaaa
aaaaaaaaaaaahhhdaaaaaeaaaeaaaaeaaaeaaaaadhhaaaaaaaaaaaaaaaaa
aaaaaaaaaaaahjaaaaeaaaaaaaaaaaaaaaaaaeakaalaaaaaaaaaaaaaaaaa
mmmmmmmmmmmmhjaaaaaaaaaaaanaaaaaaaaaaaaaaalaaaaaaaaaaaaaaaaa
haaaaaaaahhhhcccccccaaaacccoocccaadacccccccaaaaaaaaaaaaaaaaa
haaaeaacaaaaaaaaaaaaaaaaaaaooaaaaaaaaaaaaaaaaaaaaaaaaaaaaaaa
haaaaadhaeeeefaaaaaaaacaaeaopaeaacqqqqqqqciaaaaaaaaaaaaaaaaa
haeaaaahccccccaaaaaaadhmmmmmmmmmmhrrrrrrrhaaaaaaaaaaaaaaaaaa
haadaaaaaaaaahaaaaaaaahaaaaaaaaaahrsrrrsrhaaaaaaaaaaaaaaaaaa
haaaaaaaacccchaaaaaaaahaaaacqcccchrrrsrrrhaaaaaaaaaaaaaaaaaa
heaadaaaaaaaaaaaaaaaaahaaaahrrrrrrrrrrrrrhaaaaaaaaaaaaaaaaaa
hdaaaaeaacccaaaaaaaaadhaaadhhhhhhhhhhhhhhhaaaaaaaaaaaaaaaaaa
haaaaaaaaaahdaaaaaaaaahdaaahataataaaaaaaaaaaaaaaaaaaaaaaaaaa
haadaaadaaahccaafaaaaahaacchaaaaaaaaaaaaaaaaaaaaaaaaaaaaaaaa
haaaaaaaaaahahcccccccchaaaaaaaaaaaaaaaaaaaaaaaaaaaaaaaaaaaaa
hmmmmmmmmmmhaaaaauuuuuhvvvvwwauuawwaxxxxxaaaaaaaaaaaaaaaaaaa
aaaaaaaaaaaaaaaaaaaaaaaaaaaaaaaaaaaaaaaaaaaaaaaaaaaaaaaaaaaa
aaaaaaaaaaaaaaaaaaaaaaaaaaaaaaaaaaaaaaaaaaaaaaaaaaaaaaaaaaaa
aaaaaaaaaaaaaaaaaaaaaaaaaaaaaaaaaaaaaaaaaaaaaaaaaaaaaaaaaaaa
aaaaaaaaaaaaaaaaaaaaaaaaaaaaaaaaaaaaaaaaaaaaaaaaaaaaaaaaaaaa
aaaaaaaaaaaaaaaaaaaaaaaaaaaaaaaaaaaaaaaaaaaaaaaaaaaaaaaaaaaa
aaaaaaaaaaaaaaaaaaaaaaaaaaaaaaaaaaaaaaaaaaaaaaaaaaaaaaaaaaaa
aaaaaaaaaaaaaaaaaaaaaaaaaaaaaaaaaaaaaaaaaaaaaaaaaaaaaaaaaaaa
aaaaaaaaaaaaaaaaaaaaaaaaaaaaaaaaaaaaaaaaaaaaaaaaaaaaaaaaaaaa
aaaaaaaaaaaaaaaaaaaaaaaaaaaaaaaaaaaaaaaaaaaaaaaaaaaaaaaaaaaa
aaaaaaaaaaaaaaaaaaaaaaaaaaaaaaaaaaaaaaaaaaaaaaaaaaaaaaaaaaaa
aaaaaaaaaaaaaaaaaaaaaaaaaaaaaaaaaaaaaaaaaaaaaaaaaaaaaaaaaaaa
aaaaaaaaaaaaaaaaaaaaaaaaaaaaaaaaaaaaaaaaaaaaaaaaaaaaaaaaaaaa
aaaaaaaaaaaaaaaaaaaaaaaaaaaaaaaaaaaaaaaaaaaaaaaaaaaaaaaaaaaa
aaaaaaaaaaaaaaaaaaaaaaaaaaaaaaaaaaaaaaaaaaaaaaaaaaaaaaaaaaaa
aaaaaaaaaaaaaaaaaaaaaaaaaaaaaaaaaaaaaaaaaaaaaaaaaaaaaaaaaaaa
aaaaaaaaaaaaaaaaaaaaaaaaaaaaaaaaaaaaaaaaaaaaaaaaaaaaaaaaaaaa
aaaaaaaaaaaaaaaaaaaaaaaaaaaaaaaaaaaaaaaaaaaaaaaaaaaaaaaaaaaa
aaaaaaaaaaaaaaaaaaaaaaaaaaaaaaaaaaaaaaaaaaaaaaaaaaaaaaaaaaaa
aaaaaaaaaaaaaaaaaaaaaaaaaaaaaaaaaaaaaaaaaaaaaaaaaaaaaaaaaaaa
aaaaaaaaaaaaaaaaaaaaaaaaaaaaaaaaaaaaaaaaaaaaaaaaaaaaaaaaaaaa
aaaaaaaaaaaaaaaaaaaaaaaaaaaaaaaaaaaaaaaaaaaaaaaaaaaaaaaaaaaa
aaaaaaaaaaaaaaaaaaaaaaaaaaaaaaaaaaaaaaaaaaaaaaaaaaaaaaaaaaaa
aaaaaaaaaaaaaaaaaaaaaaaaaaaaaaaaaaaaaaaaaaaaaaaaaaaaaaaaaaaa
aaaaaaaaaaaaaaaaaaaaaaaaaaaaaaaaaaaaaaaaaaaaaaaaaaaaaaaaaaaa
aaaaaaaaaaaaaaaaaaaaaaaaaaaaaaaaaaaaaaaaaaaaaaaaaaaaaaaaaaaa
aaaaaaaaaaaaaaaaaaaaaaaaaaaaaaaaaaaaaaaaaaaaaaaaaaaaaaaaaaaa
aaaaaaaaaaaaaaaaaaaaaaaaaaaaaaaaaaaaaaaaaaaaaaaaaaaaaaaaaaaa
aaaaaaaaaaaaaaaaaaaaaaaaaaaaaaaaaaaaaaaaaaaaaaaaaaaaaaaaaaaa
aaaaaaaaaaaaaaaaaaaaaaaaaaaaaaaaaaaaaaaaaaaaaaaaaaaaaaaaaaaa
aaaaaaaaaaaaaaaaaaaaaaaaaaaaaaaaaaaaaaaaaaaaaaaaaaaaaaaaaaaa
yyyyyyyyyyyyyyyyyyyyyyyyyyyyyyyyyyyyyyyyyyyyyyyyyyyyyyyyyyyy
"}
