"a" = (/turf,/area)
"b" = (/obj/Brick,/turf,/area)
"c" = (/obj/OneWayBlock{tag = "icon-OneWay (WEST)"; icon_state = "OneWay"; dir = 8},/turf,/area)
"d" = (/obj/Brick/BrickTop,/turf,/area)
"e" = (/obj/Platform,/turf,/area)
"f" = (/obj/Sparkle,/turf,/area)
"g" = (/mob/Eagle,/turf,/area)
"h" = (/obj/Collectible/Emerald,/turf,/area)
"i" = (/obj/GooBlock,/turf,/area)
"j" = (/obj/OneWayBlock{tag = "icon-OneWay (EAST)"; icon_state = "OneWay"; dir = 4},/turf,/area)
"k" = (/mob/Crawler,/turf,/area)
"l" = (/obj/WoodBlock,/turf,/area)
"m" = (/obj/Ramp/Ramp1R,/turf,/area)
"n" = (/obj/Checkpoint,/turf,/area)
"o" = (/mob/FlierHorizontal{step_x = 17},/turf,/area)
"p" = (/obj/Hazard/Spikes{tag = "icon-Spikes"; icon_state = "Spikes"; dir = 2},/turf,/area)
"q" = (/obj/Collectible/Emerald,/obj/Conveyor/Switched{dir = 8},/turf,/area)
"r" = (/obj/SwitchBlock,/turf,/area)
"s" = (/obj/Conveyor/Switched,/turf,/area)
"t" = (/obj/Hazard/Spikes{tag = "icon-Spikes (EAST)"; icon_state = "Spikes"; dir = 4},/turf,/area)
"u" = (/mob/FlierVertical,/turf,/area)
"v" = (/obj/Hazard/Spikes{tag = "icon-Spikes (WEST)"; icon_state = "Spikes"; dir = 8},/turf,/area)
"w" = (/obj/Hazard/Spikes/Acidblock,/turf,/area)
"x" = (/obj/Brick/BrickTop,/obj/Conveyor,/turf,/area)
"y" = (/obj/Brick/BrickTop,/obj/Conveyor{dir = 8; icon_state = "Conveyor0"; tag = "icon-Conveyor0"},/turf,/area)
"z" = (/obj/Platform,/mob/Crawler,/turf,/area)
"A" = (/obj/Water/Surface,/turf,/area)
"B" = (/obj/Water,/turf,/area)
"C" = (/obj/Water,/obj/Collectible/Emerald,/turf,/area)
"D" = (/obj/Ramp/Ramp1L,/turf,/area)
"E" = (/obj/ToggleBlock,/turf,/area)
"F" = (/obj/ToggleBlock{tag = "icon-On"; icon_state = "On"},/turf,/area)
"G" = (/obj/Hazard/Spikes,/turf,/area)
"H" = (/obj/Brick/Cracked,/turf,/area)
"I" = (/obj/Spawner/LitBomb,/turf,/area)
"J" = (/obj/PlayerStart,/turf,/area)
"K" = (/mob/FlierHorizontal,/mob/LitBomb/Big{step_x = 9; step_y = 8},/turf,/area)
"L" = (/obj/Conveyor,/turf,/area)

(1,1,1) = {"
aaaaaaaaaaaaaaaaaaaaaaaaaaaaaaaaaaaaaaaaaaaaaabbbaaaaaaaaaaa
aaaaaaaaaaaaaaaaaaaaaaaaaaaaaaaaaaaaaaaaaaaaaacabaaaaaaaaaaa
aaaaaaaaaaaaaaaaaaaaaaaaaaaaaaaaaaaaaaaaaaaaaadabaaaaaaaaaaa
aaaaaaaaaaaaaaaaaaaaaaaaaaaaaaaaaaaaaaaaaaaaaabebaaaaaaaaaaa
aaaaaaaaaaaaaaaaaaaaaaaaaaaaaaaaaaaaaaaaaaaaaabfbaaaaaaaaaaa
aaaaaaaaaaaaaaaaaaaaaaaaaaaaaagaaaaaaaaaaaaaaababaaaaaaaaaaa
aaaaaaaaaaaaaaaaaaaaaaaaaaaahaaaaaaaaaaaaaaaaabfbaaaaaaaaaaa
aaaaaaaaaaaaaaaaaaaaaaaaaaaaaaaaaaaaaaaaaaaaaababaaaaaaaaaaa
aaaaaaaaaaaaaaaaddddaaaiaiadddaaaaaaaaaaaaaaaabfbaaaaaaaaaaa
aaaaaaaaajakaacaaaaaaaaaaaaaaaaaaaaaaaaaaaaaaababaaaaaaaaaaa
aaaaaaaaaallllaaaaaaaaaaaaaaaaaaddfdaaaaaaaaambfbaaaaaaaaaaa
aaaaaaaaaaaaahaaaaaaahhaaaaaaaaaaafaaaaaaamddbbabaaaaaaaaaaa
aaaaaaaaaaaaaaaaaaaaaanaoaaaaaaaaaaaaaaaambbbbbfbaaaaaaaaaaa
aaaaaaaaaaaadddaaaaappppaabkbaaappppaaaaabbbbbbabaaaaaaaaaaa
aaaaaaaaaaaabbbfaaaaahaaaqbrbshaaahaaaaafbbbbbbfbaaaaaaaaaaa
aaaaaaaaaaaabtaaaahaaaaaaaaaaaaaaaaaahauaavbbbbabaaaaaaaaaaa
wwwwwwwwwwwwbtaaaaaaaaaaaaaaaaaaaaaaaaaaaavbbbbfbaaaaaaaaaaa
baaaaaaaabbbbdddddddaaaaxxxeeyyyaafadddddddbbbbabaaaaaaaaaaa
baaahaadaaaaaaaaaaaaaaaaaaaeeaaaaaaaaaaaabbbbbbfbaaaaaaaaaaa
baaaaafbahhhhnaaaaaaaadaahaezahaabAAAAAAAbbbbbbabaaaaaaaaaaa
bahaaaabddddddaaaaaaafbwwwwwwwwwwbBBBBBBBbbbbbbfbaaaaaaaaaaa
baafaaaaaaaaabaaaaaaaabaaaaaaaaaabBCBBBCBbbbbbbabaaaaaaaaaaa
baaaaaaaaddddbaaaaaaaabaaaadAddddbBBBCBBBbbbbbbfbaaaaaaaaaaa
bhaafaaaaaaaaaaaaaaaaabaaaabBBBBBBBBBBBBBbbbbbbabaaaaaaaaaaa
bfaaaahaadddaaaaaaaaafbaaafbbbbbbbbbbbbbbbaaabbfbaaaaaaaaaaa
baaaaaaaaaabDaaaaaaaaabfaaabaraaraaaaaaaaEarabbabaaaaaaaaaaa
baafaaafaaabbdDanaaaaabaabbbaaaaaaaaaaaaaEaaabbfbaaaaaaaaaaa
baaaaaaaaaabbbbdddddddbaaaaaaaaaaaaaaaaaaEaaabbabaaaaaaaaaaa
bwwwwwwwwwwbbbbbbbbbbbbddddFFaEEaFFdddddddFFFbbfbaaaaaaaaaaa
bbbbbbbbbbbbbbbbbbbbbbbbbbbaaaaaaaabbbbbbbaaabbabbbbbbbaaaaa
bbbbbbbbbbbbbbbbbbbbbbbbbbbGGGGGGGGbbbbbbbaaaaafaaaaaabaaaaa
aaaaaaaaaaaaaaaaaaaaaaaaaaaaabahaHaaaaaIaaaaaaafaaaaaabaaaaa
aaaaaaaaaaaaaaaaaaaaaaaaaaaaabhahHaaaaaaaaanJaaaaaaaaabaaaaa
aaaaaaaaaaaaaaaaaaaaaaaaaaaaabdddddddddddddbdddddaaaaabaaaaa
aaaaaaaaaaaaaaaaaaaaaaaaaaaaaaaaaaaaaaaaaaaaaaaaHaaaaabaaaaa
aaaaaaaaaaaaaaaaaaaaaaaaaaaaaaaaaaaaKaaaaaaaaahaHaaaambaaaaa
aaaaaaaaaaaaaaaaaaaaaaaaaaaaaaaaaaaaaHHHHHaaaadddddddbbaaaaa
aaaaaaaaaaaaaaaaaaaaaaaaaaaaaaaaaaaaaHHHHHaaaaaaaaaaaaaaaaaa
aaaaaaaaaaaaaaaaaaaaaaaaaaaaaaaaaaaaaHHHHHaaaaaaaaaaaaaaaaaa
aaaaaaaaaaaaaaaaaaaaaaaaaaaaaaaaaaaaaHHHHHaaaaaaaaaaaaaaaaaa
aaaaaaaaaaaaaaaaaaaaaaaaaaaaaaaaaaaaaHHHHHaaaaaaaaaaaaaaaaaa
aaaaaaaaaaaaaaaaaaaaaaaaaaaaaaaaaaaaaHHHHHaaaaaaaaaaaaaaaaaa
aaaaaaaaaaaaaaaaaaaaaaaaaaaaaaaaaaaaaaaaaaaaaaaaaaaaaaaaaaaa
aaaaaaaaaaaaaaaaaaaaaaaaaaaaaaaaaaaaaaaaaaaaaaaaaaaaaaaaaaaa
aaaaaaaaaaaaaaaaaaaaaaaaaaaaaaaaaaaaaaaaaaaaaaaaaaaaaaaaaaaa
aaaaaaaaaaaaaaaaaaaaaaaaaaaaaaaaaaaaaaaaaaaaaaaaaaaaaaaaaaaa
aaaaaaaaaaaaaaaaaaaaaaaaaaaaaaaaaaaaaaaaaaaaaaaaaaaaaaaaaaaa
aaaaaaaaaaaaaaaaaaaaaaaaaaaaaaaaaaaaaaaaaaaaaaaaaaaaaaaaaaaa
aaaaaaaaaaaaaaaaaaaaaaaaaaaaaaaaaaaaaaaaaaaaaaaaaaaaaaaaaaaa
aLLLaaaaaaaaaaaaaaaaaaaaaaaaaaaaaaaaaaaaaaaaaaaaaaaaaaaaaaaa
asssaaaaaaaaaaaaaaaaaaaaaaaaaaaaaaaaaaaaaaaaaaaaaaaaaaaaaaaa
aaaaaaaaaaaaaaaaaaaaaaaaaaaaaaaaaaaaaaaaaaaaaaaaaaaaaaaaaaaa
aaaaaaaaaaaaaaaaaaaaaaaaaaaaaaaaaaaaaaaaaaaaaaaaaaaaaaaaaaaa
aaaaaaaaaaaaaaaaaaaaaaaaaaaaaaaaaaaaaaaaaaaaaaaaaaaaaaaaaaaa
aaaaaaaaaaaaaaaaaaaaaaaaaaaaaaaaaaaaaaaaaaaaaaaaaaaaaaaaaaaa
aaaaaaaaaaaaaaaaaaaaaaaaaaaaaaaaaaaaaaaaaaaaaaaaaaaaaaaaaaaa
aaaaaaaaaaaaaaaaaaaaaaaaaaaaaaaaaaaaaaaaaaaaaaaaaaaaaaaaaaaa
aaaaaaaaaaaaaaaaaaaaaaaaaaaaaaaaaaaaaaaaaaaaaaaaaaaaaaaaaaaa
aaaaaaaaaaaaaaaaaaaaaaaaaaaaaaaaaaaaaaaaaaaaaaaaaaaaaaaaaaaa
GGGGGGGGGGGGGGGGGGGGGGGGGGGGGGGGGGGGGGGGGGGGGGGGGGGGGGGGGGGG
"}
