"a" = (/turf,/area)
"b" = (/obj/Brick,/turf,/area)
"c" = (/obj/OneWayBlock{tag = "icon-OneWay (WEST)"; icon_state = "OneWay"; dir = 8},/turf,/area)
"d" = (/obj/Brick/BrickTop,/turf,/area)
"e" = (/obj/Platform,/turf,/area)
"f" = (/obj/Sparkle,/turf,/area)
"g" = (/mob/Eagle,/turf,/area)
"h" = (/obj/Collectible/Emerald,/turf,/area)
"i" = (/obj/GooBlock,/turf,/area)
"j" = (/obj/Checkpoint,/turf,/area)
"k" = (/mob/FlierHorizontal{step_x = 17},/turf,/area)
"l" = (/obj/Hazard/Spikes{tag = "icon-Spikes"; icon_state = "Spikes"; dir = 2},/turf,/area)
"m" = (/mob/Crawler,/turf,/area)
"n" = (/obj/SwitchBlock,/turf,/area)
"o" = (/obj/Hazard/Spikes{tag = "icon-Spikes (EAST)"; icon_state = "Spikes"; dir = 4},/turf,/area)
"p" = (/mob/FlierVertical,/turf,/area)
"q" = (/obj/Hazard/Spikes{tag = "icon-Spikes (WEST)"; icon_state = "Spikes"; dir = 8},/turf,/area)
"r" = (/obj/Hazard/Spikes/Acidblock,/turf,/area)
"s" = (/obj/Platform,/mob/Crawler,/turf,/area)
"t" = (/obj/Water/Surface,/turf,/area)
"u" = (/obj/Water,/turf,/area)
"v" = (/obj/Water,/obj/Collectible/Emerald,/turf,/area)
"w" = (/obj/ToggleBlock,/turf,/area)
"x" = (/obj/ToggleBlock{tag = "icon-On"; icon_state = "On"},/turf,/area)
"y" = (/obj/Hazard/Spikes,/turf,/area)
"z" = (/obj/Brick/Cracked,/turf,/area)
"A" = (/obj/Spawner/LitBomb,/turf,/area)
"B" = (/obj/PlayerStart,/turf,/area)
"C" = (/mob/FlierHorizontal,/mob/LitBomb/Big{step_x = 9; step_y = 8},/turf,/area)

(1,1,1) = {"
aaaaaaaaaaaaaaaaaaaaaaaaaaaaaaaaaaaaaaaaaaaaaabbbaaaaaaaaaaa
aaaaaaaaaaaaaaaaaaaaaaaaaaaaaaaaaaaaaaaaaaaaaacabaaaaaaaaaaa
aaaaaaaaaaaaaaaaaaaaaaaaaaaaaaaaaaaaaaaaaaaaaadabaaaaaaaaaaa
aaaaaaaaaaaaaaaaaaaaaaaaaaaaaaaaaaaaaaaaaaaaaabebaaaaaaaaaaa
aaaaaaaaaaaaaaaaaaaaaaaaaaaaaaaaaaaaaaaaaaaaaabfbaaaaaaaaaaa
aaaaaaaaaaaaaaaaaaaaaaaaaaaaaagaaaaaaaaaaaaaaababaaaaaaaaaaa
aaaaaaaaaaaaaaaaaaaaaaaaaaaahaaaaaaaaaaaaaaaaabfbaaaaaaaaaaa
aaaaaaaaaaaaaaaaaaaaaaaaaaaaaaaaaaaaaaaaaaaaaababaaaaaaaaaaa
aaaaaaaaaaaaaaaaaaadddaiaiadddaaaaaaaaaaaaaaaabfbaaaaaaaaaaa
aaaaaaaaaaaaaaaaaaaaaaaaaaaaaaaaaaaaaaaaaaaaaababaaaaaaaaaaa
aaaaaaaaaaaaaaaaaaaaaaaaaaaaaaaaddfdaaaaaaaacabfbaaaaaaaaaaa
aaaaaaaaaaaaahaaaaaaahhaaaaaaaaaaafaaaaaaahdddbabaaaaaaaaaaa
aaaaaaaaaaaaaaaaaaaaaajakaaaaaaaaaaaaaaaaadbbbbfbaaaaaaaaaaa
aaaaaaaaaaaadddaaaaallllaabmbaaallllaaaaadbbbbbabaaaaaaaaaaa
aaaaaaaaaaaabbbfaaaaahaaahbnbahaaahaaaaafbbbbbbfbaaaaaaaaaaa
aaaaaaaaaaaaboaaaahaaaaaaaaaaaaaaaaaahapaaqbbbbabaaaaaaaaaaa
rrrrrrrrrrrrboaaaaaaaaaaaaaaaaaaaaaaaaaaaaqbbbbfbaaaaaaaaaaa
baaaaaaaabbbbdddddddaaaadddeedddaafadddddddbbbbabaaaaaaaaaaa
baaahaadaaaaaaaaaaaaaaaaaaaeeaaaaaaaaaaaabbbbbbfbaaaaaaaaaaa
baaaaafbahhhhjaaaaaaaadaahaesahaabtttttttbbbbbbabaaaaaaaaaaa
bahaaaabddddddaaaaaaafbrrrrrrrrrrbuuuuuuubbbbbbfbaaaaaaaaaaa
baafaaaaaaaaabaaaaaaaabaaaaaaaaaabuvuuuvubbbbbbabaaaaaaaaaaa
baaaaaaaaddddbaaaaaaaabaaaadtddddbuuuvuuubbbbbbfbaaaaaaaaaaa
bhaafaaaaaaaaaaaaaaaaabaaaabuuuuuuuuuuuuubbbbbbabaaaaaaaaaaa
bfaaaahaadddaaaaaaaaafbaaafbbbbbbbbbbbbbbbaaabbfbaaaaaaaaaaa
baaaaaaaaaabfaaaaaaaaabfaaabanaanaaaaaaaawanabbabaaaaaaaaaaa
baafaaafaaabddaajaaaaabaabbbaaaaaaaaaaaaawaaabbfbaaaaaaaaaaa
baaaaaaaaaabbbddddddddbaaaaaaaaaaaaaaaaaawaaabbabaaaaaaaaaaa
brrrrrrrrrrbbbbbbbbbbbbddddxxawwaxxdddddddxxxbbfbaaaaaaaaaaa
bbbbbbbbbbbbbbbbbbbbbbbbbbbaaaaaaaabbbbbbbaaabbabbbbbbbaaaaa
bbbbbbbbbbbbbbbbbbbbbbbbbbbyyyyyyyybbbbbbbaaaaafaaaaaabaaaaa
aaaaaaaaaaaaaaaaaaaaaaaaaaaaabahazaaaaaAaaaaaaafaaaaaabaaaaa
aaaaaaaaaaaaaaaaaaaaaaaaaaaaabhahzaaaaaaaaajBaaaaaaaaabaaaaa
aaaaaaaaaaaaaaaaaaaaaaaaaaaaabdddddddddddddbdddddaaaaabaaaaa
aaaaaaaaaaaaaaaaaaaaaaaaaaaaaaaaaaaaaaaaaaaaaaaazaaaaabaaaaa
aaaaaaaaaaaaaaaaaaaaaaaaaaaaaaaaaaaaCaaaaaaaaahazaaaaabaaaaa
aaaaaaaaaaaaaaaaaaaaaaaaaaaaaaaaaaaaazzzzzaaaaddddddddbaaaaa
aaaaaaaaaaaaaaaaaaaaaaaaaaaaaaaaaaaaazzzzzaaaaaaaaaaaaaaaaaa
aaaaaaaaaaaaaaaaaaaaaaaaaaaaaaaaaaaaazzzzzaaaaaaaaaaaaaaaaaa
aaaaaaaaaaaaaaaaaaaaaaaaaaaaaaaaaaaaazzzzzaaaaaaaaaaaaaaaaaa
aaaaaaaaaaaaaaaaaaaaaaaaaaaaaaaaaaaaazzzzzaaaaaaaaaaaaaaaaaa
aaaaaaaaaaaaaaaaaaaaaaaaaaaaaaaaaaaaazzzzzaaaaaaaaaaaaaaaaaa
aaaaaaaaaaaaaaaaaaaaaaaaaaaaaaaaaaaaaaaaaaaaaaaaaaaaaaaaaaaa
aaaaaaaaaaaaaaaaaaaaaaaaaaaaaaaaaaaaaaaaaaaaaaaaaaaaaaaaaaaa
aaaaaaaaaaaaaaaaaaaaaaaaaaaaaaaaaaaaaaaaaaaaaaaaaaaaaaaaaaaa
aaaaaaaaaaaaaaaaaaaaaaaaaaaaaaaaaaaaaaaaaaaaaaaaaaaaaaaaaaaa
aaaaaaaaaaaaaaaaaaaaaaaaaaaaaaaaaaaaaaaaaaaaaaaaaaaaaaaaaaaa
aaaaaaaaaaaaaaaaaaaaaaaaaaaaaaaaaaaaaaaaaaaaaaaaaaaaaaaaaaaa
aaaaaaaaaaaaaaaaaaaaaaaaaaaaaaaaaaaaaaaaaaaaaaaaaaaaaaaaaaaa
aaaaaaaaaaaaaaaaaaaaaaaaaaaaaaaaaaaaaaaaaaaaaaaaaaaaaaaaaaaa
aaaaaaaaaaaaaaaaaaaaaaaaaaaaaaaaaaaaaaaaaaaaaaaaaaaaaaaaaaaa
aaaaaaaaaaaaaaaaaaaaaaaaaaaaaaaaaaaaaaaaaaaaaaaaaaaaaaaaaaaa
aaaaaaaaaaaaaaaaaaaaaaaaaaaaaaaaaaaaaaaaaaaaaaaaaaaaaaaaaaaa
aaaaaaaaaaaaaaaaaaaaaaaaaaaaaaaaaaaaaaaaaaaaaaaaaaaaaaaaaaaa
aaaaaaaaaaaaaaaaaaaaaaaaaaaaaaaaaaaaaaaaaaaaaaaaaaaaaaaaaaaa
aaaaaaaaaaaaaaaaaaaaaaaaaaaaaaaaaaaaaaaaaaaaaaaaaaaaaaaaaaaa
aaaaaaaaaaaaaaaaaaaaaaaaaaaaaaaaaaaaaaaaaaaaaaaaaaaaaaaaaaaa
aaaaaaaaaaaaaaaaaaaaaaaaaaaaaaaaaaaaaaaaaaaaaaaaaaaaaaaaaaaa
aaaaaaaaaaaaaaaaaaaaaaaaaaaaaaaaaaaaaaaaaaaaaaaaaaaaaaaaaaaa
yyyyyyyyyyyyyyyyyyyyyyyyyyyyyyyyyyyyyyyyyyyyyyyyyyyyyyyyyyyy
"}
