"a" = (/turf,/area)
"b" = (/obj/Brick,/turf,/area)
"c" = (/obj/OneWayBlock{tag = "icon-OneWay (WEST)"; icon_state = "OneWay"; dir = 8},/turf,/area)
"d" = (/obj/Brick/BrickTop,/turf,/area)
"e" = (/obj/Platform,/turf,/area)
"f" = (/obj/Sparkle,/turf,/area)
"g" = (/mob/Eagle,/turf,/area)
"h" = (/obj/Collectible/Emerald,/turf,/area)
"i" = (/obj/GooBlock,/turf,/area)
"j" = (/obj/OneWayBlock{tag = "icon-OneWay (EAST)"; icon_state = "OneWay"; dir = 4},/turf,/area)
"k" = (/mob/Crawler,/turf,/area)
"l" = (/obj/WoodBlock,/turf,/area)
"m" = (/obj/Checkpoint,/turf,/area)
"n" = (/mob/FlierHorizontal{step_x = 17},/turf,/area)
"o" = (/obj/Hazard/Spikes{tag = "icon-Spikes"; icon_state = "Spikes"; dir = 2},/turf,/area)
"p" = (/obj/SwitchBlock,/turf,/area)
"q" = (/obj/Hazard/Spikes{tag = "icon-Spikes (EAST)"; icon_state = "Spikes"; dir = 4},/turf,/area)
"r" = (/mob/FlierVertical,/turf,/area)
"s" = (/obj/Hazard/Spikes{tag = "icon-Spikes (WEST)"; icon_state = "Spikes"; dir = 8},/turf,/area)
"t" = (/obj/Hazard/Spikes/Acidblock,/turf,/area)
"u" = (/obj/Platform,/mob/Crawler,/turf,/area)
"v" = (/obj/Water/Surface,/turf,/area)
"w" = (/obj/Water,/turf,/area)
"x" = (/obj/Water,/obj/Collectible/Emerald,/turf,/area)
"y" = (/obj/ToggleBlock,/turf,/area)
"z" = (/obj/ToggleBlock{tag = "icon-On"; icon_state = "On"},/turf,/area)
"A" = (/obj/Hazard/Spikes,/turf,/area)
"B" = (/obj/Brick/Cracked,/turf,/area)
"C" = (/obj/Spawner/LitBomb,/turf,/area)
"D" = (/obj/PlayerStart,/turf,/area)
"E" = (/mob/FlierHorizontal,/mob/LitBomb/Big{step_x = 9; step_y = 8},/turf,/area)

(1,1,1) = {"
aaaaaaaaaaaaaaaaaaaaaaaaaaaaaaaaaaaaaaaaaaaaaabbbaaaaaaaaaaa
aaaaaaaaaaaaaaaaaaaaaaaaaaaaaaaaaaaaaaaaaaaaaacabaaaaaaaaaaa
aaaaaaaaaaaaaaaaaaaaaaaaaaaaaaaaaaaaaaaaaaaaaadabaaaaaaaaaaa
aaaaaaaaaaaaaaaaaaaaaaaaaaaaaaaaaaaaaaaaaaaaaabebaaaaaaaaaaa
aaaaaaaaaaaaaaaaaaaaaaaaaaaaaaaaaaaaaaaaaaaaaabfbaaaaaaaaaaa
aaaaaaaaaaaaaaaaaaaaaaaaaaaaaagaaaaaaaaaaaaaaababaaaaaaaaaaa
aaaaaaaaaaaaaaaaaaaaaaaaaaaahaaaaaaaaaaaaaaaaabfbaaaaaaaaaaa
aaaaaaaaaaaaaaaaaaaaaaaaaaaaaaaaaaaaaaaaaaaaaababaaaaaaaaaaa
aaaaaaaaaaaaaaaaaaadddaiaiadddaaaaaaaaaaaaaaaabfbaaaaaaaaaaa
aaaaaaaaajakaacaaaaaaaaaaaaaaaaaaaaaaaaaaaaaaababaaaaaaaaaaa
aaaaaaaaaallllaaaaaaaaaaaaaaaaaaddfdaaaaaaaacabfbaaaaaaaaaaa
aaaaaaaaaaaaahaaaaaaahhaaaaaaaaaaafaaaaaaahdddbabaaaaaaaaaaa
aaaaaaaaaaaaaaaaaaaaaamanaaaaaaaaaaaaaaaaadbbbbfbaaaaaaaaaaa
aaaaaaaaaaaadddaaaaaooooaabkbaaaooooaaaaadbbbbbabaaaaaaaaaaa
aaaaaaaaaaaabbbfaaaaahaaahbpbahaaahaaaaafbbbbbbfbaaaaaaaaaaa
aaaaaaaaaaaabqaaaahaaaaaaaaaaaaaaaaaaharaasbbbbabaaaaaaaaaaa
ttttttttttttbqaaaaaaaaaaaaaaaaaaaaaaaaaaaasbbbbfbaaaaaaaaaaa
baaaaaaaabbbbdddddddaaaadddeedddaafadddddddbbbbabaaaaaaaaaaa
baaahaadaaaaaaaaaaaaaaaaaaaeeaaaaaaaaaaaabbbbbbfbaaaaaaaaaaa
baaaaafbahhhhmaaaaaaaadaahaeuahaabvvvvvvvbbbbbbabaaaaaaaaaaa
bahaaaabddddddaaaaaaafbttttttttttbwwwwwwwbbbbbbfbaaaaaaaaaaa
baafaaaaaaaaabaaaaaaaabaaaaaaaaaabwxwwwxwbbbbbbabaaaaaaaaaaa
baaaaaaaaddddbaaaaaaaabaaaadvddddbwwwxwwwbbbbbbfbaaaaaaaaaaa
bhaafaaaaaaaaaaaaaaaaabaaaabwwwwwwwwwwwwwbbbbbbabaaaaaaaaaaa
bfaaaahaadddaaaaaaaaafbaaafbbbbbbbbbbbbbbbaaabbfbaaaaaaaaaaa
baaaaaaaaaabfaaaaaaaaabfaaabapaapaaaaaaaayapabbabaaaaaaaaaaa
baafaaafaaabddaamaaaaabaabbbaaaaaaaaaaaaayaaabbfbaaaaaaaaaaa
baaaaaaaaaabbbddddddddbaaaaaaaaaaaaaaaaaayaaabbabaaaaaaaaaaa
bttttttttttbbbbbbbbbbbbddddzzayyazzdddddddzzzbbfbaaaaaaaaaaa
bbbbbbbbbbbbbbbbbbbbbbbbbbbaaaaaaaabbbbbbbaaabbabbbbbbbaaaaa
bbbbbbbbbbbbbbbbbbbbbbbbbbbAAAAAAAAbbbbbbbaaaaafaaaaaabaaaaa
aaaaaaaaaaaaaaaaaaaaaaaaaaaaabahaBaaaaaCaaaaaaafaaaaaabaaaaa
aaaaaaaaaaaaaaaaaaaaaaaaaaaaabhahBaaaaaaaaamDaaaaaaaaabaaaaa
aaaaaaaaaaaaaaaaaaaaaaaaaaaaabdddddddddddddbdddddaaaaabaaaaa
aaaaaaaaaaaaaaaaaaaaaaaaaaaaaaaaaaaaaaaaaaaaaaaaBaaaaabaaaaa
aaaaaaaaaaaaaaaaaaaaaaaaaaaaaaaaaaaaEaaaaaaaaahaBaaaaabaaaaa
aaaaaaaaaaaaaaaaaaaaaaaaaaaaaaaaaaaaaBBBBBaaaaddddddddbaaaaa
aaaaaaaaaaaaaaaaaaaaaaaaaaaaaaaaaaaaaBBBBBaaaaaaaaaaaaaaaaaa
aaaaaaaaaaaaaaaaaaaaaaaaaaaaaaaaaaaaaBBBBBaaaaaaaaaaaaaaaaaa
aaaaaaaaaaaaaaaaaaaaaaaaaaaaaaaaaaaaaBBBBBaaaaaaaaaaaaaaaaaa
aaaaaaaaaaaaaaaaaaaaaaaaaaaaaaaaaaaaaBBBBBaaaaaaaaaaaaaaaaaa
aaaaaaaaaaaaaaaaaaaaaaaaaaaaaaaaaaaaaBBBBBaaaaaaaaaaaaaaaaaa
aaaaaaaaaaaaaaaaaaaaaaaaaaaaaaaaaaaaaaaaaaaaaaaaaaaaaaaaaaaa
aaaaaaaaaaaaaaaaaaaaaaaaaaaaaaaaaaaaaaaaaaaaaaaaaaaaaaaaaaaa
aaaaaaaaaaaaaaaaaaaaaaaaaaaaaaaaaaaaaaaaaaaaaaaaaaaaaaaaaaaa
aaaaaaaaaaaaaaaaaaaaaaaaaaaaaaaaaaaaaaaaaaaaaaaaaaaaaaaaaaaa
aaaaaaaaaaaaaaaaaaaaaaaaaaaaaaaaaaaaaaaaaaaaaaaaaaaaaaaaaaaa
aaaaaaaaaaaaaaaaaaaaaaaaaaaaaaaaaaaaaaaaaaaaaaaaaaaaaaaaaaaa
aaaaaaaaaaaaaaaaaaaaaaaaaaaaaaaaaaaaaaaaaaaaaaaaaaaaaaaaaaaa
aaaaaaaaaaaaaaaaaaaaaaaaaaaaaaaaaaaaaaaaaaaaaaaaaaaaaaaaaaaa
aaaaaaaaaaaaaaaaaaaaaaaaaaaaaaaaaaaaaaaaaaaaaaaaaaaaaaaaaaaa
aaaaaaaaaaaaaaaaaaaaaaaaaaaaaaaaaaaaaaaaaaaaaaaaaaaaaaaaaaaa
aaaaaaaaaaaaaaaaaaaaaaaaaaaaaaaaaaaaaaaaaaaaaaaaaaaaaaaaaaaa
aaaaaaaaaaaaaaaaaaaaaaaaaaaaaaaaaaaaaaaaaaaaaaaaaaaaaaaaaaaa
aaaaaaaaaaaaaaaaaaaaaaaaaaaaaaaaaaaaaaaaaaaaaaaaaaaaaaaaaaaa
aaaaaaaaaaaaaaaaaaaaaaaaaaaaaaaaaaaaaaaaaaaaaaaaaaaaaaaaaaaa
aaaaaaaaaaaaaaaaaaaaaaaaaaaaaaaaaaaaaaaaaaaaaaaaaaaaaaaaaaaa
aaaaaaaaaaaaaaaaaaaaaaaaaaaaaaaaaaaaaaaaaaaaaaaaaaaaaaaaaaaa
aaaaaaaaaaaaaaaaaaaaaaaaaaaaaaaaaaaaaaaaaaaaaaaaaaaaaaaaaaaa
AAAAAAAAAAAAAAAAAAAAAAAAAAAAAAAAAAAAAAAAAAAAAAAAAAAAAAAAAAAA
"}
