"aa" = (/turf,/area)
"ab" = (/obj/Autojoin/GrassCliff,/turf,/area)
"ac" = (/obj/OneWayBlock{tag = "icon-OneWay (WEST)"; icon_state = "OneWay"; dir = 8},/turf,/area)
"ad" = (/obj/OneWayBlock/MobHint{tag = "icon-OneWay (EAST)"; icon_state = "OneWay"; dir = 4},/turf,/area)
"ae" = (/mob/Crawler,/turf,/area)
"af" = (/obj/OneWayBlock/MobHint{tag = "icon-OneWay (WEST)"; icon_state = "OneWay"; dir = 8},/turf,/area)
"ag" = (/obj/WoodBlock,/turf,/area)
"ah" = (/obj/Platform,/turf,/area)
"ai" = (/mob/Eagle,/turf,/area)
"aj" = (/obj/Sparkle,/turf,/area)
"ak" = (/obj/Collectible/Emerald,/turf,/area)
"al" = (/mob/PlatformWalker,/turf,/area)
"am" = (/obj/Brick/BrickTop,/turf,/area)
"an" = (/obj/GooBlock,/turf,/area)
"ao" = (/obj/Decorative/Grass,/turf,/area)
"ap" = (/obj/Decorative/Flower,/turf,/area)
"aq" = (/obj/Ramp/Ramp1R,/turf,/area)
"ar" = (/obj/Checkpoint,/turf,/area)
"as" = (/obj/Hazard/Spikes{tag = "icon-Spikes"; icon_state = "Spikes"; dir = 2},/turf,/area)
"at" = (/mob/FlierHorizontal{step_x = 17},/turf,/area)
"au" = (/obj/Autojoin/BackgroundGrassCliff,/obj/Autojoin/GrassCliff,/turf,/area)
"av" = (/obj/Brick,/turf,/area)
"aw" = (/obj/Autojoin/BackgroundGrassCliff,/turf,/area)
"ax" = (/obj/Collectible/Emerald,/obj/Conveyor/Switched{dir = 8},/turf,/area)
"ay" = (/obj/SwitchBlock,/turf,/area)
"az" = (/obj/Conveyor/Switched,/turf,/area)
"aA" = (/obj/Hazard/Spikes{tag = "icon-Spikes (EAST)"; icon_state = "Spikes"; dir = 4},/turf,/area)
"aB" = (/obj/PlayerStart,/turf,/area)
"aC" = (/mob/FlierVertical,/turf,/area)
"aD" = (/obj/Hazard/Spikes{tag = "icon-Spikes (WEST)"; icon_state = "Spikes"; dir = 8},/turf,/area)
"aE" = (/obj/Hazard/Spikes/Acidblock,/obj/Autojoin/BackgroundGrassCliff,/turf,/area)
"aF" = (/obj/Autojoin/GrassCliff,/obj/Autojoin/BackgroundGrassCliff,/turf,/area)
"aG" = (/obj/Brick/BrickTop,/obj/Conveyor,/turf,/area)
"aH" = (/obj/Brick/BrickTop,/obj/Conveyor{dir = 8; icon_state = "Conveyor0"; tag = "icon-Conveyor0"},/turf,/area)
"aI" = (/obj/Collectible/Emerald,/obj/Autojoin/BackgroundGrassCliff,/turf,/area)
"aJ" = (/obj/Brick/BrickTop,/obj/Autojoin/BackgroundGrassCliff,/turf,/area)
"aK" = (/obj/Decorative/Flower,/mob/PlatformWalker,/turf,/area)
"aL" = (/obj/Sparkle,/obj/Autojoin/BackgroundGrassCliff,/turf,/area)
"aM" = (/obj/Brick,/obj/Autojoin/BackgroundGrassCliff,/turf,/area)
"aN" = (/obj/Platform,/mob/Crawler,/turf,/area)
"aO" = (/obj/Water/Surface,/turf,/area)
"aP" = (/obj/Hazard/Spikes/Acidblock,/turf,/area)
"aQ" = (/obj/Water,/turf,/area)
"aR" = (/mob/Squishy,/turf,/area)
"aS" = (/obj/Water,/obj/Collectible/Emerald,/turf,/area)
"aT" = (/obj/Autojoin/GrassCliff,/obj/Water,/turf,/area)
"aU" = (/obj/Ramp/Ramp1L,/turf,/area)
"aV" = (/obj/ToggleBlock,/turf,/area)
"aW" = (/obj/Decorative/Mushroom/Small,/turf,/area)
"aX" = (/obj/ToggleBlock{tag = "icon-On"; icon_state = "On"},/turf,/area)
"aY" = (/mob/IronCrate,/turf,/area)
"aZ" = (/obj/Hazard/Spikes,/turf,/area)
"ba" = (/obj/Conveyor/Switched/Off/West{SignalChannel = "BrickBreaker"},/turf,/area)
"bb" = (/obj/Brick/Cracked/Stone,/turf,/area)
"bc" = (/obj/Spawner/LitBomb,/obj/Autojoin/BackgroundGrassCliff,/turf,/area)
"bd" = (/obj/Autojoin/BackgroundGrassCliff,/obj/Decorative/Mushroom/Small,/turf,/area)
"be" = (/obj/Checkpoint,/obj/Autojoin/BackgroundGrassCliff,/turf,/area)
"bf" = (/obj/Autojoin/BackgroundGrassCliff,/obj/Decorative/Mushroom,/turf,/area)
"bg" = (/obj/Autojoin/BackgroundGrassCliff,/obj/SwitchBlock{SignalChannel = "BrickBreaker"},/turf,/area)
"bh" = (/obj/Autojoin/BackgroundGrassCliff,/obj/Brick/Cracked/Stone,/turf,/area)
"bi" = (/obj/Autojoin/BackgroundGrassCliff,/mob/LitBomb/Big{step_x = 0; step_y = 0},/turf,/area)
"bj" = (/obj/Ramp/Ramp1R,/obj/Autojoin/BackgroundGrassCliff,/turf,/area)
"bk" = (/mob/FlierHorizontal,/turf,/area)
"bl" = (/obj/Conveyor,/turf,/area)
"bm" = (/obj/Hazard/Spikes,/obj/Autojoin/BackgroundGrassCliff,/turf,/area)

(1,1,1) = {"
aaaaaaaaaaaaaaaaaaaaaaaaaaaaaaaaaaaaaaaaaaaaaaaaaaaaaaaaaaaaaaaaaaaaaaaaaaaaaaaaaaaaaaaaaaaaababababaaaaaaaaaaaaaaaaaaaa
aaaaaaaaaaaaaaaaaaababaaaaaaaaaaaaaaaaaaaaaaaaaaaaaaaaaaaaaaaaaaaaaaaaaaaaaaaaaaaaaaaaaaaaaaacaaababaaaaaaaaaaaaaaaaaaaa
aaaaaaaaaaaaaaaaaaababaaaaaaabaaaaaaaaaaaaaaaaadaaaeaaaaafaaaaaaaaaaaaaaaaaaaaaaaaaaaaaaaaaaabaaababaaaaaaaaaaaaaaaaaaaa
aaaaaaaaaaaaaaabababababababababababaaaaaaaaaaaaagagagagaaaaaaaaaaaaaaaaaaaaaaaaaaaaaaaaaaaaabahababaaaaaaaaaaaaaaaaaaaa
aaaaaaaaaaabaaaaaaababaaaaaaaaaaabaaaaaaaaaaaaaaaaaaaaaaaaaaaaaiaaaaaaaaaaaaaaaaaaaaaaaaaaaaabajababaaaaaaaaaaaaaaaaaaaa
aaaaaaaaaaabaaaaaaababaaaaaaaaaaaaaaaaaaaaaaaaaaaaaaaaaaakaaaaaaaaaaaaaaaaaaaaaaaaaaaaaaaaaaabaaababaaaaaaaaaaaaaaaaaaaa
aaaaaaababababababababababaaaaaaaaaaalaaaaaaaaaaaaaaaaaaalaaaaaaaaaaaaaaaaaaaaaaaaaaaaaaaaaaabajababaaaaaaaaaaaaaaaaaaaa
aaaaaaababababababababababaaaaaaamamamamaaanaaanaaanaaamamamaaaaaaaaaaaaaaaaaaaaaaaaaaaaaaaaabaaababaaaaaaaaaaaaaaaaaaaa
aaaaaaaaaaabaaaaaaababaaaaaaaaaaaaaaaaaaaaaaaaaaaaaaaaaaaaaaaaaaaaaaaaaaaaaaaaaaaaaaaaaaaaaaabajababaaaaaaaaaaaaaaaaaaaa
aaaaaaaaaaabaaaaaaababaaaaaaaaaaaaaaaaaaaaaaaaaaaaaaaaaaaaaaaaaaamamajamaaaaaaaaaaaaaaaaaaaaabaaababaaaaaaaaaaaaaaaaaaaa
aaaaaaaaaaaoaoaoaaaaaaaaaaaaaaaaaaaaaaaaaaakakaaaaaaaaaaaaaaaaaaaaaaajaaaaaaaaaaaaaaaaaaapaqabajababaaaaaaaaaaaaaaaaaaaa
aaaaaaababababababaaaaaaaaakaaaaaaaaaaaaalaaaraaaaaaaaaaaaaaaaaaaaaaaaaaaaaaaaaaaaaaaqababababaaababaaaaaaaaaaaaaaaaaaaa
aaaaaaaaaaababababaaaaaaaaalaaaaaaaaaaaaasasasasataaaaaaaaaaaaaaasasasasaaaaaaaaaaaqabababababajababaaaaaaaaaaaaaaaaaaaa
aaaaaaaaaaabauauabaaaaaaabababaaaaaaaaaaaaaaaaaaaaaaavaeavaaaaaaaaaaaaaaaaaaaaaaaaababababababaaababaaaaaaaaaaaaaaaaaaaa
aaaaaaaaaaaaawawaaaaaaaaabababajaaaaaaaaaaakaaaaaaaxavayavazakaaaaaaakaaaaaaaaaaaaababababababajababaaaaaaaaaaaaaaaaaaaa
aaaaaaaaaaaaawawaaaaaaaaabaAaaaaaBaaakaaaaaaaaaaaaaaaaaaaaaaaaaaaaaaaaaaaaakaaaCaaaaaDababababaaababaaaaaaaaaaaaaaaaaaaa
aEaEaEaEaEaEaEaEaEaEaEaEabaAaoaoapaoaaaaaaaaaaaaalaaaaaaaaaaaaaaaaaaaaaaapaaalaaaaaaaDababababajababaaaaaaaaaaaaaaaaaaaa
aFawawawawawawawawaFaFaFababababababababaaaaaaaaaGaGaGahahaHaHaHaaaaaaaaabababababababababababaaababaaaaaaaaaaaaaaaaaaaa
aFawawawaIawawaJawawawawaaaaaaaaaaaaaaaaaaaaaKaaaaaaaaahahaaaaaaaaaaaaaaaaaaaaaaaaababababababajababaaaaaaaaaaaaaaaaaaaa
aFawawawawawaLaMawaIaIaIakaraaaaaaaaaaaaaaaaabaaaaakaaahaNaaakaaaaabaOaOaOaOaOaOaOababababababaaababaaaaaaaaaaaaaaaaaaaa
aFawaIawawawawaMaJaJaJaJamamaaaaaaaaaaaaaaaaabaPaPaPaPaPaPaPaPaPaPabaQaQaQaQaQaQaQababababababajababaaaaaaaaaaaaaaaaaaaa
aFawawaLawawawawawawawawaaavaaaaaaaaaaaaaaaaabaaaaaaaaaaaaaaaaaaaRabaQaSaQaQaQaSaQababababababaaababaaaaaaaaaaaaaaaaaaaa
aFawawawawawawawawaJaJaJamavaaaaaaaaaaaaaaajabaaaaaaababaOaTabababaTaQaQaQaSaQaQaQababababababajababaaaaaaaaaaaaaaaaaaaa
aFaIawawaLawawawawawawawaaaaaaaaaaaaaaaaaaaaabaaaaaaababaQaQaQaQaQaQaQaQaQaQaQaQaQababababababaaababaaaaaaaaaaaaaaaaaaaa
aFaLawawawawaIawawaFaFaFaUaaaaaaaaaaaaaaaaaaabaaaaaaababababababababababababababababaaaaaaababajababaaaaaaaaaaaaaaaaaaaa
aFawawawawawawawawawawaFabaUaaaaaaaaaaaaaaapabaaaaabababaaayaaaaayaaaaaaaaaaaaaaaaaVaaayaaababaaababaaaaaaaaaaaaaaaaaaaa
aFawawaLawawawaLawawawaFababaUaaaraaapaaaaababaaaaabababaaaaaaaaaaaaaaaaaaaaaaaaaaaVaaaaaaabaFaLaFabaaaaaaaaaaaaaaaaaaaa
aFawawawawawawawawawawaFabababababababababababaaaaaaaaaaaaaaaaaaaaaaaaaaaaaWaaaaaaaVaaaaaaabaFawaFabaaaaaaaaaaaaaaaaaaaa
aFaEaEaEaEaEaEaEaEaEaEaFabababababababababababababababaXaXaaaVaVaaaXaXabababababababaXaXaXabaFaLaFababababababababaaaaaa
abababababababababababababababaaaaaYabababababababababaaaaaaaaaaaaaaaaabaFaFaFaFaFaFawawawaFaFawaFaFaFaFaFaFaFababaaaaaa
abababababababababababababababaaaaaYabababababababababaZaZaZaZaZaZaZaZabaFaFaFaFaFaFawawawawawaLawawawawawawaFababaaaaaa
aaaaaaaaaaaaaaaaaaaaaaaaababaaaababaababaFaFaFaFaFaFabababakaaakaabbaaaaawawawbcawawawawawawawaLawawawawawawaFababaaaaaa
aaaaaaaaaaaaaaaaaaaaaaaaababaaaaaaaaaaaaawawawawawaFabababaaakaaakbbaaaWawawawawbdawawbebdbfawawawawawawawawaFababaaaaaa
aaaaaaaaaaaaaaaaaaaaaaaaababaaaaaaaaaaaaawawawawawaFababababababababababaFaFaFaFaFaFaFaFaFaFaFaFaFawawawawawaFababaaaaaa
aaaaaaaaaaaaaaaaaaaaaaaaababaaaaaaaaaaaabgawawawawaFaFaFaFaFaFaFaFaFababababababaFaFabababababaFbhawawawawawaFababaaaaaa
aaaaaaaaaaaaaaaaaaaaaaaaababaaaaaaaaaaaaawawawawawawawawawawawawawawaaaaaaaaaaaaawawaaaaaaaaakawbhbiawbfawbjaFababaaaaaa
aaaaaaaaaaaaaaaaaaaaaaababababaaaaaaaaaaawawawawawawawawawawawawawawaaaaaaaaaaaaawawaaaaaaaaabaFaFaFaFaFaFaFaFababaaaaaa
aaaaaaaaaaaaaaaaaaaaaaababababaaaaaaaaaaaFaFaFaFaFaFaFaFaFaFaFaFaFaFabaUaaaaaaaaawawaaaaaaaaabababaFaFababababababaaaaaa
aaaaaaaaaaaaaaaaaaaaaaaaaaaaaaagaaapaaababababaFaFababaFaFababaFaFabababaabkaaaaawawaaaaaaaaaaaaaaawawaaaaaaaaaaaaaaaaaa
aaaaaaaaaaaaaaaaaaaaabababababaaababababababaaawawaaaaawawaaaaawawaaababaaaaaaaaawawaaaaaaaaaaaaaaawawaaaaaaaaaaaaaaaaaa
aaaaaaaaaaaaaaaaaaaaabababababaaababababababaaawawaaaaawawaaaaawawaaaaaaaaaaaaaaawawaaaaaaaaaaaaaaawawaaaaaaaaaaaaaaaaaa
aaaaaaaaaaaaaaaaaaaaabababababaZababababaaaaaaawawaaaaawawaaaaawawaaaaaaaaaaaaaaawawaaaaaaaaaaaaaaawawaaaaaaaaaaaaaaaaaa
aaaaaaaaaaaaaaaaaaaaabaFaFaFabababaFabaaaaaaaaawawaaaaawawaaaaawawaaaaaaaaaaaaaaawawaaaaaaaaaaaaaaawawaaaaaaaaaaaaaaaaaa
aaaaaaaaaaaaaaaaaaaaaaawawawawawawawaaaaaaaaaaawawawawawawaaaaawawaaaaaaaaaaaaaaawawawawawawawawawawawaaaaaaaaaaaaaaaaaa
aaaaaaaaaaaaaaaaaaaaaaawawawawawawawaaaaaaaaaaawawawawawawaaaaawawaaaaaaaaaaaaaaawawawawawawawawawawawaaaaaaaaaaaaaaaaaa
aaaaaaaaaaaaaaaaaaaaaaawawawawawawawaaaaaaaaaaawawaaaaaaaaaaaaawawaaaaaaaaaaaaaaaaaaaaaaaaawawaaaaaaaaaaaaaaaaaaaaaaaaaa
aaaaaaaaaaaaaaaaaaaaaaawawawawawawawaaaaaaaaaaawawaaaaaaaaaaaaawawawawawawawaaaaaaaaaaaaaaawawaaaaaaaaaaaaaaaaaaaaaaaaaa
aaaaaaaaaaaaaaaaaaaaaaawawaaaaaaawawaaaaaaaaaaawawaaaaaaaaaaaaawawawawawawawaaaaaaaaaaaaaaawawaaaaaaaaaaaaaaaaaaaaaaaaaa
aaaaaaaaaaaaaaaaaaaaaaawawaaaaaaawawaaaaaaaaaaawawaaaaaaaaaaaaawawaaaaaaawawaaaaaaaaaaaaaaawawaaaaaaaaaaaaaaaaaaaaaaaaaa
aablblblaaaaaaaaaaaaaaawawaaaaaaawawaaaaaaaaaaawawaaaaaaaaaaaaawawaaaaaaawawawawawawawawawawawaaaaaaaaaaaaaaaaaaaaaaaaaa
aaazazazaaaaaaaaaaaaaaawawawawawawawaaaaaaaaaaawawaaaaaaaaaaaaawawaaaaaaawawawawawawawawawawawaaaaaaaaaaaaaaaaaaaaaaaaaa
aaaaaaaaaaaaaaaaaaaaaaawawawawawawawaaaaaaaaaaawawaaaaaaaaaaaaawawaaaaaaaaaaaaaaaaaaaaaaaaaaaaaaaaaaaaaaaaaaaaaaaaaaaaaa
aaaaaaaaaaaaaaaaaaaaaaawawawawawawawaaaaaaaaaaawawaaaaaaaaaaaaawawaaaaaaaaaaaaaaaaaaaaaaaaaaaaaaaaaaaaaaaaaaaaaaaaaaaaaa
aaaaaaaaaaaaaaaaaaaaaaawawawawawawawaaaaaaaaaaawawaaaaaaaaaaaaawawaaaaaaaaaaaaaaaaaaaaaaaaaaaaaaaaaaaaaaaaaaaaaaaaaaaaaa
aaaaaaaaaaaaaaaaaaaaaaawawawawawawawaaaaaaaaaaawawaaaaaaaaaaaaawawaaaaaaaaaaaaaaaaaaaaaaaaaaaaaaaaaaaaaaaaaaaaaaaaaaaaaa
aaaaaaaaaaaaaaaaaaaaaaawawawawawawawaaaaaaaaaaawawaaaaaaaaaaaaawawaaaaaaaaaaaaaaaaaaaaaaaaaaaaaaaaaaaaaaaaaaaaaaaaaaaaaa
aaaaaaaaaaaaaaaaaaaaaaawawawawawawawaaaaaaaaaaawawaaaaaaaaaaaaawawaaaaaaaaaaaaaaaaaaaaaaaaaaaaaaaaaaaaaaaaaaaaaaaaaaaaaa
aaaaaaaaaaaaaaaaaaaaaaawawawawawawawaaaaaaaaaaawawaaaaaaaaaaaaawawaaaaaaaaaaaaaaaaaaaaaaaaaaaaaaaaaaaaaaaaaaaaaaaaaaaaaa
aaaaaaaaaaaaaaaaaaaaaaawawawawawawawaaaaaaaaaaawawaaaaaaaaaaaaawawaaaaaaaaaaaaaaaaaaaaaaaaaaaaaaaaaaaaaaaaaaaaaaaaaaaaaa
aZaZaZaZaZaZaZaZaZaZaZbmbmbmbmbmbmbmaZaZaZaZaZbmbmaZaZaZaZaZaZbmbmaZaZaZaZaZaZaZaZaZaZaZaZaZaZaZaZaZaZaZaZaZaZaZaZaZaZaZ
"}
