"aa" = (/turf,/area)
"ab" = (/obj/Autojoin/GrassCliff,/turf,/area)
"ac" = (/obj/OneWayBlock{tag = "icon-OneWay (WEST)"; icon_state = "OneWay"; dir = 8},/turf,/area)
"ad" = (/obj/OneWayBlock/MobHint{tag = "icon-OneWay (EAST)"; icon_state = "OneWay"; dir = 4},/turf,/area)
"ae" = (/mob/Crawler,/turf,/area)
"af" = (/obj/OneWayBlock/MobHint{tag = "icon-OneWay (WEST)"; icon_state = "OneWay"; dir = 8},/turf,/area)
"ag" = (/obj/WoodBlock,/turf,/area)
"ah" = (/obj/Platform,/turf,/area)
"ai" = (/mob/Eagle,/turf,/area)
"aj" = (/obj/Sparkle,/turf,/area)
"ak" = (/obj/Collectible/Emerald,/turf,/area)
"al" = (/mob/PlatformWalker,/turf,/area)
"am" = (/obj/Brick/BrickTop,/turf,/area)
"an" = (/obj/GooBlock,/turf,/area)
"ao" = (/obj/Decorative/Grass,/turf,/area)
"ap" = (/obj/Decorative/Flower,/turf,/area)
"aq" = (/obj/Ramp/Ramp1R,/turf,/area)
"ar" = (/obj/Checkpoint,/turf,/area)
"as" = (/obj/Hazard/Spikes{tag = "icon-Spikes"; icon_state = "Spikes"; dir = 2},/turf,/area)
"at" = (/mob/FlierHorizontal{step_x = 17},/turf,/area)
"au" = (/obj/Autojoin/BackgroundGrassCliff,/obj/Autojoin/GrassCliff,/turf,/area)
"av" = (/obj/Brick,/turf,/area)
"aw" = (/obj/Autojoin/BackgroundGrassCliff,/turf,/area)
"ax" = (/obj/Collectible/Emerald,/obj/Conveyor/Switched{dir = 8},/turf,/area)
"ay" = (/obj/SwitchBlock,/turf,/area)
"az" = (/obj/Conveyor/Switched,/turf,/area)
"aA" = (/obj/Hazard/Spikes{tag = "icon-Spikes (EAST)"; icon_state = "Spikes"; dir = 4},/turf,/area)
"aB" = (/obj/PlayerStart,/turf,/area)
"aC" = (/mob/FlierVertical,/turf,/area)
"aD" = (/obj/Hazard/Spikes{tag = "icon-Spikes (WEST)"; icon_state = "Spikes"; dir = 8},/turf,/area)
"aE" = (/obj/Hazard/Spikes/Acidblock,/obj/Autojoin/BackgroundGrassCliff,/turf,/area)
"aF" = (/obj/Decorative/Flower,/obj/Decorative/Grass,/turf,/area)
"aG" = (/obj/Autojoin/GrassCliff,/obj/Autojoin/BackgroundGrassCliff,/turf,/area)
"aH" = (/obj/Brick/BrickTop,/obj/Conveyor,/turf,/area)
"aI" = (/obj/Brick/BrickTop,/obj/Conveyor{dir = 8; icon_state = "Conveyor0"; tag = "icon-Conveyor0"},/turf,/area)
"aJ" = (/obj/Collectible/Emerald,/obj/Autojoin/BackgroundGrassCliff,/turf,/area)
"aK" = (/obj/Brick/BrickTop,/obj/Autojoin/BackgroundGrassCliff,/turf,/area)
"aL" = (/obj/Decorative/Flower,/mob/PlatformWalker,/turf,/area)
"aM" = (/obj/Sparkle,/obj/Autojoin/BackgroundGrassCliff,/turf,/area)
"aN" = (/obj/Brick,/obj/Autojoin/BackgroundGrassCliff,/turf,/area)
"aO" = (/obj/Platform,/mob/Crawler,/turf,/area)
"aP" = (/obj/Water/Surface,/turf,/area)
"aQ" = (/obj/Hazard/Spikes/Acidblock,/turf,/area)
"aR" = (/obj/Water,/turf,/area)
"aS" = (/mob/Squishy,/turf,/area)
"aT" = (/obj/Water,/obj/Collectible/Emerald,/turf,/area)
"aU" = (/obj/Autojoin/GrassCliff,/obj/Water,/turf,/area)
"aV" = (/obj/Ramp/Ramp1L,/turf,/area)
"aW" = (/obj/ToggleBlock,/turf,/area)
"aX" = (/obj/Decorative/Mushroom/Small,/turf,/area)
"aY" = (/obj/ToggleBlock{tag = "icon-On"; icon_state = "On"},/turf,/area)
"aZ" = (/mob/IronCrate,/turf,/area)
"ba" = (/obj/Hazard/Spikes,/turf,/area)
"bb" = (/obj/Conveyor/Switched/Off/West{SignalChannel = "BrickBreaker"},/turf,/area)
"bc" = (/obj/Brick/Cracked/Stone,/turf,/area)
"bd" = (/obj/Spawner/LitBomb,/obj/Autojoin/BackgroundGrassCliff,/turf,/area)
"be" = (/obj/Autojoin/BackgroundGrassCliff,/obj/Decorative/Mushroom/Small,/turf,/area)
"bf" = (/obj/Checkpoint,/obj/Autojoin/BackgroundGrassCliff,/turf,/area)
"bg" = (/obj/Autojoin/BackgroundGrassCliff,/obj/Decorative/Mushroom,/turf,/area)
"bh" = (/obj/Autojoin/BackgroundGrassCliff,/obj/SwitchBlock{SignalChannel = "BrickBreaker"},/turf,/area)
"bi" = (/obj/Autojoin/BackgroundGrassCliff,/obj/Brick/Cracked/Stone,/turf,/area)
"bj" = (/obj/Autojoin/BackgroundGrassCliff,/mob/LitBomb/Big{step_x = 0; step_y = 0},/turf,/area)
"bk" = (/obj/Ramp/Ramp1R,/obj/Autojoin/BackgroundGrassCliff,/turf,/area)
"bl" = (/mob/FlierHorizontal,/turf,/area)
"bm" = (/obj/Conveyor,/turf,/area)
"bn" = (/obj/Hazard/Spikes,/obj/Autojoin/BackgroundGrassCliff,/turf,/area)

(1,1,1) = {"
aaaaaaaaaaaaaaaaaaaaaaaaaaaaaaaaaaaaaaaaaaaaaaaaaaaaaaaaaaaaaaaaaaaaaaaaaaaaaaaaaaaaaaaaaaaaababababaaaaaaaaaaaaaaaaaaaa
aaaaaaaaaaaaaaaaaaababaaaaaaaaaaaaaaaaaaaaaaaaaaaaaaaaaaaaaaaaaaaaaaaaaaaaaaaaaaaaaaaaaaaaaaacaaababaaaaaaaaaaaaaaaaaaaa
aaaaaaaaaaaaaaaaaaababaaaaaaabaaaaaaaaaaaaaaaaadaaaeaaaaafaaaaaaaaaaaaaaaaaaaaaaaaaaaaaaaaaaabaaababaaaaaaaaaaaaaaaaaaaa
aaaaaaaaaaaaaaabababababababababababaaaaaaaaaaaaagagagagaaaaaaaaaaaaaaaaaaaaaaaaaaaaaaaaaaaaabahababaaaaaaaaaaaaaaaaaaaa
aaaaaaaaaaabaaaaaaababaaaaaaaaaaabaaaaaaaaaaaaaaaaaaaaaaaaaaaaaiaaaaaaaaaaaaaaaaaaaaaaaaaaaaabajababaaaaaaaaaaaaaaaaaaaa
aaaaaaaaaaabaaaaaaababaaaaaaaaaaaaaaaaaaaaaaaaaaaaaaaaaaakaaaaaaaaaaaaaaaaaaaaaaaaaaaaaaaaaaabaaababaaaaaaaaaaaaaaaaaaaa
aaaaaaababababababababababaaaaaaaaaaalaaaaaaaaaaaaaaaaaaalaaaaaaaaaaaaaaaaaaaaaaaaaaaaaaaaaaabajababaaaaaaaaaaaaaaaaaaaa
aaaaaaababababababababababaaaaaaamamamamaaanaaanaaanaaamamamaaaaaaaaaaaaaaaaaaaaaaaaaaaaaaaaabaaababaaaaaaaaaaaaaaaaaaaa
aaaaaaaaaaabaaaaaaababaaaaaaaaaaaaaaaaaaaaaaaaaaaaaaaaaaaaaaaaaaaaaaaaaaaaaaaaaaaaaaaaaaaaaaabajababaaaaaaaaaaaaaaaaaaaa
aaaaaaaaaaabaaaaaaababaaaaaaaaaaaaaaaaaaaaaaaaaaaaaaaaaaaaaaaaaaamamajamaaaaaaaaaaaaaaaaaaaaabaaababaaaaaaaaaaaaaaaaaaaa
aaaaaaaaaaaoaoaoaaaaaaaaaaaaaaaaaaaaaaaaaaakakaaaaaaaaaaaaaaaaaaaaaaajaaaaaaaaaaaaaaaaaaapaqabajababaaaaaaaaaaaaaaaaaaaa
aaaaaaababababababaaaaaaaaakaaaaaaaaaaaaalaaaraaaaaaaaaaaaaaaaaaaaaaaaaaaaaaaaaaaaaaaqababababaaababaaaaaaaaaaaaaaaaaaaa
aaaaaaaaaaababababaaaaaaaaalaaaaaaaaaaaaasasasasataaaaaaaaaaaaaaasasasasaaaaaaaaaaaqabababababajababaaaaaaaaaaaaaaaaaaaa
aaaaaaaaaaabauauabaaaaaaabababaaaaaaaaaaaaaaaaaaaaaaavaeavaaaaaaaaaaaaaaaaaaaaaaaaababababababaaababaaaaaaaaaaaaaaaaaaaa
aaaaaaaaaaaaawawaaaaaaaaabababajaaaaaaaaaaakaaaaaaaxavayavazakaaaaaaakaaaaaaaaaaaaababababababajababaaaaaaaaaaaaaaaaaaaa
aaaaaaaaaaaaawawaaaaaaaaabaAaaaaaBaaakaaaaaaaaaaaaaaaaaaaaaaaaaaaaaaaaaaaaakaaaCaaaaaDababababaaababaaaaaaaaaaaaaaaaaaaa
aEaEaEaEaEaEaEaEaEaEaEaEabaAaoaoaFaoaaaaaaaaaaaaalaaaaaaaaaaaaaaaaaaaaaaapaaalaaaaaaaDababababajababaaaaaaaaaaaaaaaaaaaa
aGawawawawawawawawaGaGaGababababababababaaaaaaaaaHaHaHahahaIaIaIaaaaaaaaabababababababababababaaababaaaaaaaaaaaaaaaaaaaa
aGawawawaJawawaKawawawawaaaaaaaaaaaaaaaaaaaaaLaaaaaaaaahahaaaaaaaaaaaaaaaaaaaaaaaaababababababajababaaaaaaaaaaaaaaaaaaaa
aGawawawawawaMaNawaJaJaJakaraaaaaaaaaaaaaaaaabaaaaakaaahaOaaakaaaaabaPaPaPaPaPaPaPababababababaaababaaaaaaaaaaaaaaaaaaaa
aGawaJawawawawaNaKaKaKaKamamaaaaaaaaaaaaaaaaabaQaQaQaQaQaQaQaQaQaQabaRaRaRaRaRaRaRababababababajababaaaaaaaaaaaaaaaaaaaa
aGawawaMawawawawawawawawaaavaaaaaaaaaaaaaaaaabaaaaaaaaaaaaaaaaaaaSabaRaTaRaRaRaTaRababababababaaababaaaaaaaaaaaaaaaaaaaa
aGawawawawawawawawaKaKaKamavaaaaaaaaaaaaaaajabaaaaaaababaPaUabababaUaRaRaRaTaRaRaRababababababajababaaaaaaaaaaaaaaaaaaaa
aGaJawawaMawawawawawawawaaaaaaaaaaaaaaaaaaaaabaaaaaaababaRaRaRaRaRaRaRaRaRaRaRaRaRababababababaaababaaaaaaaaaaaaaaaaaaaa
aGaMawawawawaJawawaGaGaGaVaaaaaaaaaaaaaaaaaaabaaaaaaababababababababababababababababaaaaaaababajababaaaaaaaaaaaaaaaaaaaa
aGawawawawawawawawawawaGabaVaaaaaaaaaaaaaaapabaaaaabababaaayaaaaayaaaaaaaaaaaaaaaaaWaaayaaababaaababaaaaaaaaaaaaaaaaaaaa
aGawawaMawawawaMawawawaGababaVaaaraaapaaaaababaaaaabababaaaaaaaaaaaaaaaaaaaaaaaaaaaWaaaaaaabaGaMaGabaaaaaaaaaaaaaaaaaaaa
aGawawawawawawawawawawaGabababababababababababaaaaaaaaaaaaaaaaaaaaaaaaaaaaaXaaaaaaaWaaaaaaabaGawaGabaaaaaaaaaaaaaaaaaaaa
aGaEaEaEaEaEaEaEaEaEaEaGabababababababababababababababaYaYaaaWaWaaaYaYabababababababaYaYaYabaGaMaGababababababababaaaaaa
abababababababababababababababaaaaaZabababababababababaaaaaaaaaaaaaaaaabaGaGaGaGaGaGawawawaGaGawaGaGaGaGaGaGaGababaaaaaa
abababababababababababababababaaaaaZabababababababababbabababababababaabaGaGaGaGaGaGawawawawawaMawawawawawawaGababaaaaaa
aaaaaaaaaaaaaaaaaaaaaaaaababaaaabbbbababaGaGaGaGaGaGabababakaaakaabcaaaaawawawbdawawawawawawawaMawawawawawawaGababaaaaaa
aaaaaaaaaaaaaaaaaaaaaaaaababaaaaaaaaaaaaawawawawawaGabababaaakaaakbcaaaXawawawawbeawawbfbebgawawawawawawawawaGababaaaaaa
aaaaaaaaaaaaaaaaaaaaaaaaababaaaaaaaaaaaaawawawawawaGababababababababababaGaGaGaGaGaGaGaGaGaGaGaGaGawawawawawaGababaaaaaa
aaaaaaaaaaaaaaaaaaaaaaaaababaaaaaaaaaaaabhawawawawaGaGaGaGaGaGaGaGaGababababababaGaGabababababaGbiawawawawawaGababaaaaaa
aaaaaaaaaaaaaaaaaaaaaaaaababaaaaaaaaaaaaawawawawawawawawawawawawawawaaaaaaaaaaaaawawaaaaaaaaakawbibjawbgawbkaGababaaaaaa
aaaaaaaaaaaaaaaaaaaaaaababababaaaaaaaaaaawawawawawawawawawawawawawawaaaaaaaaaaaaawawaaaaaaaaabaGaGaGaGaGaGaGaGababaaaaaa
aaaaaaaaaaaaaaaaaaaaaaababababaaaaaaaaaaaGaGaGaGaGaGaGaGaGaGaGaGaGaGabaVaaaaaaaaawawaaaaaaaaabababaGaGababababababaaaaaa
aaaaaaaaaaaaaaaaaaaaaaaaaaaaaaagaaapaaababababaGaGababaGaGababaGaGabababaablaaaaawawaaaaaaaaaaaaaaawawaaaaaaaaaaaaaaaaaa
aaaaaaaaaaaaaaaaaaaaabababababaaababababababaaawawaaaaawawaaaaawawaaababaaaaaaaaawawaaaaaaaaaaaaaaawawaaaaaaaaaaaaaaaaaa
aaaaaaaaaaaaaaaaaaaaabababababaaababababababaaawawaaaaawawaaaaawawaaaaaaaaaaaaaaawawaaaaaaaaaaaaaaawawaaaaaaaaaaaaaaaaaa
aaaaaaaaaaaaaaaaaaaaabababababbaababababaaaaaaawawaaaaawawaaaaawawaaaaaaaaaaaaaaawawaaaaaaaaaaaaaaawawaaaaaaaaaaaaaaaaaa
aaaaaaaaaaaaaaaaaaaaabaGaGaGabababaGabaaaaaaaaawawaaaaawawaaaaawawaaaaaaaaaaaaaaawawaaaaaaaaaaaaaaawawaaaaaaaaaaaaaaaaaa
aaaaaaaaaaaaaaaaaaaaaaawawawawawawawaaaaaaaaaaawawawawawawaaaaawawaaaaaaaaaaaaaaawawawawawawawawawawawaaaaaaaaaaaaaaaaaa
aaaaaaaaaaaaaaaaaaaaaaawawawawawawawaaaaaaaaaaawawawawawawaaaaawawaaaaaaaaaaaaaaawawawawawawawawawawawaaaaaaaaaaaaaaaaaa
aaaaaaaaaaaaaaaaaaaaaaawawawawawawawaaaaaaaaaaawawaaaaaaaaaaaaawawaaaaaaaaaaaaaaaaaaaaaaaaawawaaaaaaaaaaaaaaaaaaaaaaaaaa
aaaaaaaaaaaaaaaaaaaaaaawawawawawawawaaaaaaaaaaawawaaaaaaaaaaaaawawawawawawawaaaaaaaaaaaaaaawawaaaaaaaaaaaaaaaaaaaaaaaaaa
aaaaaaaaaaaaaaaaaaaaaaawawaaaaaaawawaaaaaaaaaaawawaaaaaaaaaaaaawawawawawawawaaaaaaaaaaaaaaawawaaaaaaaaaaaaaaaaaaaaaaaaaa
aaaaaaaaaaaaaaaaaaaaaaawawaaaaaaawawaaaaaaaaaaawawaaaaaaaaaaaaawawaaaaaaawawaaaaaaaaaaaaaaawawaaaaaaaaaaaaaaaaaaaaaaaaaa
aabmbmbmaaaaaaaaaaaaaaawawaaaaaaawawaaaaaaaaaaawawaaaaaaaaaaaaawawaaaaaaawawawawawawawawawawawaaaaaaaaaaaaaaaaaaaaaaaaaa
aaazazazaaaaaaaaaaaaaaawawawawawawawaaaaaaaaaaawawaaaaaaaaaaaaawawaaaaaaawawawawawawawawawawawaaaaaaaaaaaaaaaaaaaaaaaaaa
aaaaaaaaaaaaaaaaaaaaaaawawawawawawawaaaaaaaaaaawawaaaaaaaaaaaaawawaaaaaaaaaaaaaaaaaaaaaaaaaaaaaaaaaaaaaaaaaaaaaaaaaaaaaa
aaaaaaaaaaaaaaaaaaaaaaawawawawawawawaaaaaaaaaaawawaaaaaaaaaaaaawawaaaaaaaaaaaaaaaaaaaaaaaaaaaaaaaaaaaaaaaaaaaaaaaaaaaaaa
aaaaaaaaaaaaaaaaaaaaaaawawawawawawawaaaaaaaaaaawawaaaaaaaaaaaaawawaaaaaaaaaaaaaaaaaaaaaaaaaaaaaaaaaaaaaaaaaaaaaaaaaaaaaa
aaaaaaaaaaaaaaaaaaaaaaawawawawawawawaaaaaaaaaaawawaaaaaaaaaaaaawawaaaaaaaaaaaaaaaaaaaaaaaaaaaaaaaaaaaaaaaaaaaaaaaaaaaaaa
aaaaaaaaaaaaaaaaaaaaaaawawawawawawawaaaaaaaaaaawawaaaaaaaaaaaaawawaaaaaaaaaaaaaaaaaaaaaaaaaaaaaaaaaaaaaaaaaaaaaaaaaaaaaa
aaaaaaaaaaaaaaaaaaaaaaawawawawawawawaaaaaaaaaaawawaaaaaaaaaaaaawawaaaaaaaaaaaaaaaaaaaaaaaaaaaaaaaaaaaaaaaaaaaaaaaaaaaaaa
aaaaaaaaaaaaaaaaaaaaaaawawawawawawawaaaaaaaaaaawawaaaaaaaaaaaaawawaaaaaaaaaaaaaaaaaaaaaaaaaaaaaaaaaaaaaaaaaaaaaaaaaaaaaa
aaaaaaaaaaaaaaaaaaaaaaawawawawawawawaaaaaaaaaaawawaaaaaaaaaaaaawawaaaaaaaaaaaaaaaaaaaaaaaaaaaaaaaaaaaaaaaaaaaaaaaaaaaaaa
babababababababababababnbnbnbnbnbnbnbabababababnbnbababababababnbnbababababababababababababababababababababababababababa
"}
