"a" = (/turf,/area)
"b" = (/mob/Eagle,/turf,/area)
"c" = (/obj/Collectible/Emerald,/turf,/area)
"d" = (/obj/BrickTop,/turf,/area)
"e" = (/obj/GooBlock,/turf,/area)
"f" = (/obj/Sparkle,/turf,/area)
"g" = (/obj/Checkpoint,/turf,/area)
"h" = (/mob/FlierHorizontal{step_x = 17},/turf,/area)
"i" = (/obj/Brick,/turf,/area)
"j" = (/obj/Hazard/Spikes{tag = "icon-Spikes"; icon_state = "Spikes"; dir = 2},/turf,/area)
"k" = (/mob/Crawler,/turf,/area)
"l" = (/obj/SwitchBlock,/turf,/area)
"m" = (/obj/Hazard/Spikes{tag = "icon-Spikes (EAST)"; icon_state = "Spikes"; dir = 4},/turf,/area)
"n" = (/mob/FlierVertical,/turf,/area)
"o" = (/obj/Hazard/Spikes{tag = "icon-Spikes (WEST)"; icon_state = "Spikes"; dir = 8},/turf,/area)
"p" = (/obj/Hazard/Spikes/Acidblock,/turf,/area)
"q" = (/obj/PlayerStart,/turf,/area)
"r" = (/obj/Platform,/turf,/area)
"s" = (/obj/Platform,/mob/Crawler,/turf,/area)
"t" = (/obj/Water/Surface,/turf,/area)
"u" = (/obj/Water,/turf,/area)
"v" = (/obj/Water,/obj/Collectible/Emerald,/turf,/area)
"w" = (/obj/ToggleBlock,/turf,/area)
"x" = (/obj/ToggleBlock{tag = "icon-On"; icon_state = "On"},/turf,/area)
"y" = (/obj/Hazard/Spikes,/turf,/area)

(1,1,1) = {"
aaaaaaaaaaaaaaaaaaaaaaaaaaaaaaaaaaaaaaaaaaaaaaaaaaaaaaaaaaaa
aaaaaaaaaaaaaaaaaaaaaaaaaaaaaaaaaaaaaaaaaaaaaaaaaaaaaaaaaaaa
aaaaaaaaaaaaaaaaaaaaaaaaaaaaaaaaaaaaaaaaaaaaaaaaaaaaaaaaaaaa
aaaaaaaaaaaaaaaaaaaaaaaaaaaaaaaaaaaaaaaaaaaaaaaaaaaaaaaaaaaa
aaaaaaaaaaaaaaaaaaaaaaaaaaaaaaaaaaaaaaaaaaaaaaaaaaaaaaaaaaaa
aaaaaaaaaaaaaaaaaaaaaaaaaaaaaabaaaaaaaaaaaaaaaaaaaaaaaaaaaaa
aaaaaaaaaaaaaaaaaaaaaaaaaaaacaaaaaaaaaaaaaaaaaaaaaaaaaaaaaaa
aaaaaaaaaaaaaaaaaaaaaaaaaaaaaaaaaaaaaaaaaaaaaaaaaaaaaaaaaaaa
aaaaaaaaaaaaaaaaaaadddaeaeadddaaaaaaaaaaaaaaaaaaaaaaaaaaaaaa
aaaaaaaaaaaaaaaaaaaaaaaaaaaaaaaaaaaaaaaaaaaaaaaaaaaaaaaaaaaa
aaaaaaaaaaaaaaaaaaaaaaaaaaaaaaaaddfdaaaaaaaaaaaaaaaaaaaaaaaa
aaaaaaaaaaaaacaaaaaaaccaaaaaaaaaaafaaaaaaacdaaaaaaaaaaaaaaaa
aaaaaaaaaaaaaaaaaaaaaagahaaaaaaaaaaaaaaaaadiaaaaaaaaaaaaaaaa
aaaaaaaaaaaadddaaaaajjjjaaikiaaajjjjaaaaadiiaaaaaaaaaaaaaaaa
aaaaaaaaaaaaiiifaaaaacaaaciliacaaacaaaaafiiaaaaaaaaaaaaaaaaa
aaaaaaaaaaaaimaaaacaaaaaaaaaaaaaaaaaacanaaoaaaaaaaaaaaaaaaaa
ppppppppppppimaaaaaaaaaaaaqaaaaaaaaaaaaaaaoaaaaaaaaaaaaaaaaa
iaaaaaaaaiiiidddddddaaaadddrrdddaafadddddddaaaaaaaaaaaaaaaaa
iaaacaadaaaaaaaaaaaaaaaaaaarraaaaaaaaaaaaaaaaaaaaaaaaaaaaaaa
iaaaaafiaccccgaaaaaaaadaacarsacaaitttttttijaaaaaaaaaaaaaaaaa
iacaaaaiddddddaaaaaaafippppppppppiuuuuuuuiaaaaaaaaaaaaaaaaaa
iaafaaaaaaaaaiaaaaaaaaiaaaaaaaaaaiuvuuuvuiaaaaaaaaaaaaaaaaaa
iaaaaaaaaddddiaaaaaaaaiaaaadtddddiuuuvuuuiaaaaaaaaaaaaaaaaaa
icaafaaaaaaaaaaaaaaaaaiaaaaiuuuuuuuuuuuuuiaaaaaaaaaaaaaaaaaa
ifaaaacaadddaaaaaaaaafiaaafiiiiiiiiiiiiiiiaaaaaaaaaaaaaaaaaa
iaaaaaaaaaaifaaaaaaaaaifaaaialaalaaaaaaaaaaaaaaaaaaaaaaaaaaa
iaafaaafaaaiddaagaaaaaiaaiiiaaaaaaaaaaaaaaaaaaaaaaaaaaaaaaaa
iaaaaaaaaaaiaiddddddddiaaaaaaaaaaaaaaaaaaaaaaaaaaaaaaaaaaaaa
ippppppppppiaaaaawwwwwiddddxxawwaxxadddddaaaaaaaaaaaaaaaaaaa
aaaaaaaaaaaaaaaaaaaaaaaaaaaaaaaaaaaaaaaaaaaaaaaaaaaaaaaaaaaa
aaaaaaaaaaaaaaaaaaaaaaaaaaaaaaaaaaaaaaaaaaaaaaaaaaaaaaaaaaaa
aaaaaaaaaaaaaaaaaaaaaaaaaaaaaaaaaaaaaaaaaaaaaaaaaaaaaaaaaaaa
aaaaaaaaaaaaaaaaaaaaaaaaaaaaaaaaaaaaaaaaaaaaaaaaaaaaaaaaaaaa
aaaaaaaaaaaaaaaaaaaaaaaaaaaaaaaaaaaaaaaaaaaaaaaaaaaaaaaaaaaa
aaaaaaaaaaaaaaaaaaaaaaaaaaaaaaaaaaaaaaaaaaaaaaaaaaaaaaaaaaaa
aaaaaaaaaaaaaaaaaaaaaaaaaaaaaaaaaaaaaaaaaaaaaaaaaaaaaaaaaaaa
aaaaaaaaaaaaaaaaaaaaaaaaaaaaaaaaaaaaaaaaaaaaaaaaaaaaaaaaaaaa
aaaaaaaaaaaaaaaaaaaaaaaaaaaaaaaaaaaaaaaaaaaaaaaaaaaaaaaaaaaa
aaaaaaaaaaaaaaaaaaaaaaaaaaaaaaaaaaaaaaaaaaaaaaaaaaaaaaaaaaaa
aaaaaaaaaaaaaaaaaaaaaaaaaaaaaaaaaaaaaaaaaaaaaaaaaaaaaaaaaaaa
aaaaaaaaaaaaaaaaaaaaaaaaaaaaaaaaaaaaaaaaaaaaaaaaaaaaaaaaaaaa
aaaaaaaaaaaaaaaaaaaaaaaaaaaaaaaaaaaaaaaaaaaaaaaaaaaaaaaaaaaa
aaaaaaaaaaaaaaaaaaaaaaaaaaaaaaaaaaaaaaaaaaaaaaaaaaaaaaaaaaaa
aaaaaaaaaaaaaaaaaaaaaaaaaaaaaaaaaaaaaaaaaaaaaaaaaaaaaaaaaaaa
aaaaaaaaaaaaaaaaaaaaaaaaaaaaaaaaaaaaaaaaaaaaaaaaaaaaaaaaaaaa
aaaaaaaaaaaaaaaaaaaaaaaaaaaaaaaaaaaaaaaaaaaaaaaaaaaaaaaaaaaa
aaaaaaaaaaaaaaaaaaaaaaaaaaaaaaaaaaaaaaaaaaaaaaaaaaaaaaaaaaaa
aaaaaaaaaaaaaaaaaaaaaaaaaaaaaaaaaaaaaaaaaaaaaaaaaaaaaaaaaaaa
aaaaaaaaaaaaaaaaaaaaaaaaaaaaaaaaaaaaaaaaaaaaaaaaaaaaaaaaaaaa
aaaaaaaaaaaaaaaaaaaaaaaaaaaaaaaaaaaaaaaaaaaaaaaaaaaaaaaaaaaa
aaaaaaaaaaaaaaaaaaaaaaaaaaaaaaaaaaaaaaaaaaaaaaaaaaaaaaaaaaaa
aaaaaaaaaaaaaaaaaaaaaaaaaaaaaaaaaaaaaaaaaaaaaaaaaaaaaaaaaaaa
aaaaaaaaaaaaaaaaaaaaaaaaaaaaaaaaaaaaaaaaaaaaaaaaaaaaaaaaaaaa
aaaaaaaaaaaaaaaaaaaaaaaaaaaaaaaaaaaaaaaaaaaaaaaaaaaaaaaaaaaa
aaaaaaaaaaaaaaaaaaaaaaaaaaaaaaaaaaaaaaaaaaaaaaaaaaaaaaaaaaaa
aaaaaaaaaaaaaaaaaaaaaaaaaaaaaaaaaaaaaaaaaaaaaaaaaaaaaaaaaaaa
aaaaaaaaaaaaaaaaaaaaaaaaaaaaaaaaaaaaaaaaaaaaaaaaaaaaaaaaaaaa
aaaaaaaaaaaaaaaaaaaaaaaaaaaaaaaaaaaaaaaaaaaaaaaaaaaaaaaaaaaa
aaaaaaaaaaaaaaaaaaaaaaaaaaaaaaaaaaaaaaaaaaaaaaaaaaaaaaaaaaaa
yyyyyyyyyyyyyyyyyyyyyyyyyyyyyyyyyyyyyyyyyyyyyyyyyyyyyyyyyyyy
"}
