"a" = (/turf,/area)
"b" = (/mob/Eagle,/turf,/area)
"c" = (/obj/Brick,/turf,/area)
"d" = (/obj/Sparkle,/turf,/area)
"e" = (/obj/Collectible/Emerald,/turf,/area)
"f" = (/mob/Ghost,/turf,/area)
"g" = (/obj/Checkpoint,/turf,/area)
"h" = (/mob/FlierHorizontal{step_x = 17},/turf,/area)
"i" = (/obj/Hazard/Spikes{tag = "icon-Spikes"; icon_state = "Spikes"; dir = 2},/turf,/area)
"j" = (/obj/Hazard/Spikes{tag = "icon-Spikes (EAST)"; icon_state = "Spikes"; dir = 4},/turf,/area)
"k" = (/mob/FlierVertical,/turf,/area)
"l" = (/obj/Hazard/Spikes{tag = "icon-Spikes (WEST)"; icon_state = "Spikes"; dir = 8},/turf,/area)
"m" = (/obj/Hazard/Spikes/Acidblock,/turf,/area)
"n" = (/obj/PlayerStart,/turf,/area)
"o" = (/obj/Platform,/turf,/area)
"p" = (/obj/Platform,/mob/Crawler,/turf,/area)
"q" = (/obj/Water/Surface,/turf,/area)
"r" = (/obj/Water,/turf,/area)
"s" = (/obj/Water,/obj/Collectible/Emerald,/turf,/area)
"t" = (/obj/Brick,/obj/Brick,/turf,/area)
"u" = (/obj/GooBlock,/turf,/area)
"v" = (/obj/Hazard/Spikes,/turf,/area)

(1,1,1) = {"
aaaaaaaaaaaaaaaaaaaaaaaaaaaaaaaaaaaaaaaaaaaaaaaaaaaaaaaaaaaa
aaaaaaaaaaaaaaaaaaaaaaaaaaaaaaaaaaaaaaaaaaaaaaaaaaaaaaaaaaaa
aaaaaaaaaaaaaaaaaaaaaaaaaaaaaaaaaaaaaaaaaaaaaaaaaaaaaaaaaaaa
aaaaaaaaaaaaaaaaaaaaaaaaaaaaaaaaaaaaaaaaaaaaaaaaaaaaaaaaaaaa
aaaaaaaaaaaaaaaaaaaaaaaaaaaaaaaaaaaaaaaaaaaaaaaaaaaaaaaaaaaa
aaaaaaaaaaaaaaaaaaaaaaaaaaaaaabaaaaaaaaaaaaaaaaaaaaaaaaaaaaa
aaaaaaaaaaaaaaaaaaaaaaaaaaaaaaaaaaaaaaaaaaaaaaaaaaaaaaaaaaaa
aaaaaaaaaaaaaaaaaaaaaaaaaaaaaaaaaaaaaaaaaaaaaaaaaaaaaaaaaaaa
aaaaaaaaaaaaaaaaaaaaaaaaaaaaaaaaaaaaaaaaaaaaaaaaaaaaaaaaaaaa
aaaaaaaaaaaaaaaaaaaaaaaaaaaaaaaaaaaaaaaaaaaaaaaaaaaaaaaaaaaa
aaaaaaaaaaaaaaaaaaaaaaaaaaaaaaaaccdcaaaaaaaaaaaaaaaaaaaaaaaa
aaaaaaaaaaaaaeaaaaaaaeeaaaaaaaaaaadaafaaaaecaaaaaaaaaaaaaaaa
aaaaaaaaaaaaaaaaaaaaaagahaaaaaaaaaaaaaaaaaccaaaaaaaaaaaaaaaa
aaaaaaaaaaaacccaaaaaiiiiaaaaaaaaiiiiaaaaacccaaaaaaaaaaaaaaaa
aaaaaaaaaaaacccdaaaaaeaaaeaaaaeaaaeaaaaadccaaaaaaaaaaaaaaaaa
aaaaaaaaaaaacjaaaaeaaaaaaaaaaaaaaaaaaeakaalaaaaaaaaaaaaaaaaa
mmmmmmmmmmmmcjaaaaaaaaaaaanaaaaaaaaaaaaaaalaaaaaaaaaaaaaaaaa
caaaaaaaacccccccccccaaaacccoocccaadacccccccaaaaaaaaaaaaaaaaa
caaaeaacaaaaaaaaaaaaaaaaaaaooaaaaaaaaaaaaaaaaaaaaaaaaaaaaaaa
caaaaadcaeeeegaaaaaaaacaaeaopaeaacqqqqqqqciaaaaaaaaaaaaaaaaa
caeaaaacccccccaaaaaaadcmmmmmmmmmmcrrrrrrrcaaaaaaaaaaaaaaaaaa
caadaaaaaaaaacaaaaaaaacaaaaaaaaaacrsrrrsrcaaaaaaaaaaaaaaaaaa
caaaaaaaacccccaaaaaaaacaaaacqcccccrrrsrrrcaaaaaaaaaaaaaaaaaa
ceaadaaaaaaaaaaaaaaaaacaaaacrrrrrrrrrrrrrcaaaaaaaaaaaaaaaaaa
cdaaaaeaacccaaaaaaaaadcaaadcccccccccccccccaaaaaaaaaaaaaaaaaa
caaaaaaaaaacdaaaaaaaaacdaaacaaaaaaaaaaaaaaaaaaaaaaaaaaaaaaaa
caadaaadaaacccaagaaaaacaacccaaaaaaaaaaaaaaaaaaaaaaaaaaaaaaaa
caaaaaaaaaacaccccccccccaaaaaaaaaaaaaaaaaaaaaaaaaaaaaaaaaaaaa
cmmmmmmmmmmcaaaaaaaaaaccccccctuuuuaaaaaaaaaaaaaaaaaaaaaaaaaa
aaaaaaaaaaaaaaaaaaaaaaaaaaaaaaaaaaaaaaaaaaaaaaaaaaaaaaaaaaaa
aaaaaaaaaaaaaaaaaaaaaaaaaaaaaaaaaaaaaaaaaaaaaaaaaaaaaaaaaaaa
aaaaaaaaaaaaaaaaaaaaaaaaaaaaaaaaaaaaaaaaaaaaaaaaaaaaaaaaaaaa
aaaaaaaaaaaaaaaaaaaaaaaaaaaaaaaaaaaaaaaaaaaaaaaaaaaaaaaaaaaa
aaaaaaaaaaaaaaaaaaaaaaaaaaaaaaaaaaaaaaaaaaaaaaaaaaaaaaaaaaaa
aaaaaaaaaaaaaaaaaaaaaaaaaaaaaaaaaaaaaaaaaaaaaaaaaaaaaaaaaaaa
aaaaaaaaaaaaaaaaaaaaaaaaaaaaaaaaaaaaaaaaaaaaaaaaaaaaaaaaaaaa
aaaaaaaaaaaaaaaaaaaaaaaaaaaaaaaaaaaaaaaaaaaaaaaaaaaaaaaaaaaa
aaaaaaaaaaaaaaaaaaaaaaaaaaaaaaaaaaaaaaaaaaaaaaaaaaaaaaaaaaaa
aaaaaaaaaaaaaaaaaaaaaaaaaaaaaaaaaaaaaaaaaaaaaaaaaaaaaaaaaaaa
aaaaaaaaaaaaaaaaaaaaaaaaaaaaaaaaaaaaaaaaaaaaaaaaaaaaaaaaaaaa
aaaaaaaaaaaaaaaaaaaaaaaaaaaaaaaaaaaaaaaaaaaaaaaaaaaaaaaaaaaa
aaaaaaaaaaaaaaaaaaaaaaaaaaaaaaaaaaaaaaaaaaaaaaaaaaaaaaaaaaaa
aaaaaaaaaaaaaaaaaaaaaaaaaaaaaaaaaaaaaaaaaaaaaaaaaaaaaaaaaaaa
aaaaaaaaaaaaaaaaaaaaaaaaaaaaaaaaaaaaaaaaaaaaaaaaaaaaaaaaaaaa
aaaaaaaaaaaaaaaaaaaaaaaaaaaaaaaaaaaaaaaaaaaaaaaaaaaaaaaaaaaa
aaaaaaaaaaaaaaaaaaaaaaaaaaaaaaaaaaaaaaaaaaaaaaaaaaaaaaaaaaaa
aaaaaaaaaaaaaaaaaaaaaaaaaaaaaaaaaaaaaaaaaaaaaaaaaaaaaaaaaaaa
aaaaaaaaaaaaaaaaaaaaaaaaaaaaaaaaaaaaaaaaaaaaaaaaaaaaaaaaaaaa
aaaaaaaaaaaaaaaaaaaaaaaaaaaaaaaaaaaaaaaaaaaaaaaaaaaaaaaaaaaa
aaaaaaaaaaaaaaaaaaaaaaaaaaaaaaaaaaaaaaaaaaaaaaaaaaaaaaaaaaaa
aaaaaaaaaaaaaaaaaaaaaaaaaaaaaaaaaaaaaaaaaaaaaaaaaaaaaaaaaaaa
aaaaaaaaaaaaaaaaaaaaaaaaaaaaaaaaaaaaaaaaaaaaaaaaaaaaaaaaaaaa
aaaaaaaaaaaaaaaaaaaaaaaaaaaaaaaaaaaaaaaaaaaaaaaaaaaaaaaaaaaa
aaaaaaaaaaaaaaaaaaaaaaaaaaaaaaaaaaaaaaaaaaaaaaaaaaaaaaaaaaaa
aaaaaaaaaaaaaaaaaaaaaaaaaaaaaaaaaaaaaaaaaaaaaaaaaaaaaaaaaaaa
aaaaaaaaaaaaaaaaaaaaaaaaaaaaaaaaaaaaaaaaaaaaaaaaaaaaaaaaaaaa
aaaaaaaaaaaaaaaaaaaaaaaaaaaaaaaaaaaaaaaaaaaaaaaaaaaaaaaaaaaa
aaaaaaaaaaaaaaaaaaaaaaaaaaaaaaaaaaaaaaaaaaaaaaaaaaaaaaaaaaaa
aaaaaaaaaaaaaaaaaaaaaaaaaaaaaaaaaaaaaaaaaaaaaaaaaaaaaaaaaaaa
vvvvvvvvvvvvvvvvvvvvvvvvvvvvvvvvvvvvvvvvvvvvvvvvvvvvvvvvvvvv
"}
