"a" = (/turf,/area)
"b" = (/mob/Eagle,/turf,/area)
"c" = (/obj/Brick,/turf,/area)
"d" = (/obj/Sparkle,/turf,/area)
"e" = (/obj/Collectible/Emerald,/turf,/area)
"f" = (/obj/Checkpoint,/turf,/area)
"g" = (/mob/FlierHorizontal{step_x = 17},/turf,/area)
"h" = (/obj/Hazard/Spikes{tag = "icon-Spikes"; icon_state = "Spikes"; dir = 2},/turf,/area)
"i" = (/obj/Hazard/Spikes{tag = "icon-Spikes (EAST)"; icon_state = "Spikes"; dir = 4},/turf,/area)
"j" = (/mob/FlierVertical,/turf,/area)
"k" = (/obj/Hazard/Spikes{tag = "icon-Spikes (WEST)"; icon_state = "Spikes"; dir = 8},/turf,/area)
"l" = (/obj/Hazard/Spikes/Acidblock,/turf,/area)
"m" = (/obj/PlayerStart,/turf,/area)
"n" = (/obj/Platform,/turf,/area)
"o" = (/obj/Platform,/mob/Crawler,/turf,/area)
"p" = (/obj/Water/Surface,/turf,/area)
"q" = (/obj/Water,/turf,/area)
"r" = (/obj/Water,/obj/Collectible/Emerald,/turf,/area)
"s" = (/obj/Brick,/obj/Brick,/turf,/area)
"t" = (/obj/GooBlock,/turf,/area)
"u" = (/obj/Hazard/Spikes,/turf,/area)

(1,1,1) = {"
aaaaaaaaaaaaaaaaaaaaaaaaaaaaaaaaaaaaaaaaaaaaaaaaaaaaaaaaaaaa
aaaaaaaaaaaaaaaaaaaaaaaaaaaaaaaaaaaaaaaaaaaaaaaaaaaaaaaaaaaa
aaaaaaaaaaaaaaaaaaaaaaaaaaaaaaaaaaaaaaaaaaaaaaaaaaaaaaaaaaaa
aaaaaaaaaaaaaaaaaaaaaaaaaaaaaaaaaaaaaaaaaaaaaaaaaaaaaaaaaaaa
aaaaaaaaaaaaaaaaaaaaaaaaaaaaaaaaaaaaaaaaaaaaaaaaaaaaaaaaaaaa
aaaaaaaaaaaaaaaaaaaaaaaaaaaaaabaaaaaaaaaaaaaaaaaaaaaaaaaaaaa
aaaaaaaaaaaaaaaaaaaaaaaaaaaaaaaaaaaaaaaaaaaaaaaaaaaaaaaaaaaa
aaaaaaaaaaaaaaaaaaaaaaaaaaaaaaaaaaaaaaaaaaaaaaaaaaaaaaaaaaaa
aaaaaaaaaaaaaaaaaaaaaaaaaaaaaaaaaaaaaaaaaaaaaaaaaaaaaaaaaaaa
aaaaaaaaaaaaaaaaaaaaaaaaaaaaaaaaaaaaaaaaaaaaaaaaaaaaaaaaaaaa
aaaaaaaaaaaaaaaaaaaaaaaaaaaaaaaaccdcaaaaaaaaaaaaaaaaaaaaaaaa
aaaaaaaaaaaaaeaaaaaaaeeaaaaaaaaaaadaaaaaaaecaaaaaaaaaaaaaaaa
aaaaaaaaaaaaaaaaaaaaaafagaaaaaaaaaaaaaaaaaccaaaaaaaaaaaaaaaa
aaaaaaaaaaaacccaaaaahhhhaaaaaaaahhhhaaaaacccaaaaaaaaaaaaaaaa
aaaaaaaaaaaacccdaaaaaeaaaeaaaaeaaaeaaaaadccaaaaaaaaaaaaaaaaa
aaaaaaaaaaaaciaaaaeaaaaaaaaaaaaaaaaaaeajaakaaaaaaaaaaaaaaaaa
llllllllllllciaaaaaaaaaaaamaaaaaaaaaaaaaaakaaaaaaaaaaaaaaaaa
caaaaaaaacccccccccccadaacccnncccaadacccccccaaaaaaaaaaaaaaaaa
caaaeaacaaaaaaaaaaaaaaaaaaannaaaaaaaaaaaaaaaaaaaaaaaaaaaaaaa
caaaaadcaeeeefaaaaaaaacaaeanoaeaacpppppppchaaaaaaaaaaaaaaaaa
caeaaaacccccccaaaaaaadcllllllllllcqqqqqqqcaaaaaaaaaaaaaaaaaa
caadaaaaaaaaacaaaaaaaacaaaaaaaaaacqrqqqrqcaaaaaaaaaaaaaaaaaa
caaaaaaaacccccaaaaaadacaaaacpcccccqqqrqqqcaaaaaaaaaaaaaaaaaa
ceaadaaaaaaaaaaaaaaaaacaaaacqqqqqqqqqqqqqcaaaaaaaaaaaaaaaaaa
cdaaaaeaacccaaaaaaadaacaaadcccccccccccccccaaaaaaaaaaaaaaaaaa
caaaaaaaaaacdaaaaaaaaacdaaacaaaaaaaaaaaaaaaaaaaaaaaaaaaaaaaa
caadaaadaaacccaafaaaaacaacccaaaaaaaaaaaaaaaaaaaaaaaaaaaaaaaa
caaaaaaaaaacaccccccccccaaaaaaaaaaaaaaaaaaaaaaaaaaaaaaaaaaaaa
cllllllllllcaaaaaaaaaacccccccsttttaaaaaaaaaaaaaaaaaaaaaaaaaa
aaaaaaaaaaaaaaaaaaaaaaaaaaaaaaaaaaaaaaaaaaaaaaaaaaaaaaaaaaaa
aaaaaaaaaaaaaaaaaaaaaaaaaaaaaaaaaaaaaaaaaaaaaaaaaaaaaaaaaaaa
aaaaaaaaaaaaaaaaaaaaaaaaaaaaaaaaaaaaaaaaaaaaaaaaaaaaaaaaaaaa
aaaaaaaaaaaaaaaaaaaaaaaaaaaaaaaaaaaaaaaaaaaaaaaaaaaaaaaaaaaa
aaaaaaaaaaaaaaaaaaaaaaaaaaaaaaaaaaaaaaaaaaaaaaaaaaaaaaaaaaaa
aaaaaaaaaaaaaaaaaaaaaaaaaaaaaaaaaaaaaaaaaaaaaaaaaaaaaaaaaaaa
aaaaaaaaaaaaaaaaaaaaaaaaaaaaaaaaaaaaaaaaaaaaaaaaaaaaaaaaaaaa
aaaaaaaaaaaaaaaaaaaaaaaaaaaaaaaaaaaaaaaaaaaaaaaaaaaaaaaaaaaa
aaaaaaaaaaaaaaaaaaaaaaaaaaaaaaaaaaaaaaaaaaaaaaaaaaaaaaaaaaaa
aaaaaaaaaaaaaaaaaaaaaaaaaaaaaaaaaaaaaaaaaaaaaaaaaaaaaaaaaaaa
aaaaaaaaaaaaaaaaaaaaaaaaaaaaaaaaaaaaaaaaaaaaaaaaaaaaaaaaaaaa
aaaaaaaaaaaaaaaaaaaaaaaaaaaaaaaaaaaaaaaaaaaaaaaaaaaaaaaaaaaa
aaaaaaaaaaaaaaaaaaaaaaaaaaaaaaaaaaaaaaaaaaaaaaaaaaaaaaaaaaaa
aaaaaaaaaaaaaaaaaaaaaaaaaaaaaaaaaaaaaaaaaaaaaaaaaaaaaaaaaaaa
aaaaaaaaaaaaaaaaaaaaaaaaaaaaaaaaaaaaaaaaaaaaaaaaaaaaaaaaaaaa
aaaaaaaaaaaaaaaaaaaaaaaaaaaaaaaaaaaaaaaaaaaaaaaaaaaaaaaaaaaa
aaaaaaaaaaaaaaaaaaaaaaaaaaaaaaaaaaaaaaaaaaaaaaaaaaaaaaaaaaaa
aaaaaaaaaaaaaaaaaaaaaaaaaaaaaaaaaaaaaaaaaaaaaaaaaaaaaaaaaaaa
aaaaaaaaaaaaaaaaaaaaaaaaaaaaaaaaaaaaaaaaaaaaaaaaaaaaaaaaaaaa
aaaaaaaaaaaaaaaaaaaaaaaaaaaaaaaaaaaaaaaaaaaaaaaaaaaaaaaaaaaa
aaaaaaaaaaaaaaaaaaaaaaaaaaaaaaaaaaaaaaaaaaaaaaaaaaaaaaaaaaaa
aaaaaaaaaaaaaaaaaaaaaaaaaaaaaaaaaaaaaaaaaaaaaaaaaaaaaaaaaaaa
aaaaaaaaaaaaaaaaaaaaaaaaaaaaaaaaaaaaaaaaaaaaaaaaaaaaaaaaaaaa
aaaaaaaaaaaaaaaaaaaaaaaaaaaaaaaaaaaaaaaaaaaaaaaaaaaaaaaaaaaa
aaaaaaaaaaaaaaaaaaaaaaaaaaaaaaaaaaaaaaaaaaaaaaaaaaaaaaaaaaaa
aaaaaaaaaaaaaaaaaaaaaaaaaaaaaaaaaaaaaaaaaaaaaaaaaaaaaaaaaaaa
aaaaaaaaaaaaaaaaaaaaaaaaaaaaaaaaaaaaaaaaaaaaaaaaaaaaaaaaaaaa
aaaaaaaaaaaaaaaaaaaaaaaaaaaaaaaaaaaaaaaaaaaaaaaaaaaaaaaaaaaa
aaaaaaaaaaaaaaaaaaaaaaaaaaaaaaaaaaaaaaaaaaaaaaaaaaaaaaaaaaaa
aaaaaaaaaaaaaaaaaaaaaaaaaaaaaaaaaaaaaaaaaaaaaaaaaaaaaaaaaaaa
uuuuuuuuuuuuuuuuuuuuuuuuuuuuuuuuuuuuuuuuuuuuuuuuuuuuuuuuuuuu
"}
