"a" = (/turf,/area)
"b" = (/mob/IronCrate,/turf,/area)
"c" = (/obj/Conveyor/Switched/Off,/turf,/area)
"d" = (/obj/SwitchBlock,/turf,/area)
"e" = (/obj/Brick/BrickTop,/turf,/area)
"f" = (/obj/Sparkle,/turf,/area)
"g" = (/obj/WoodBlock,/turf,/area)
"h" = (/obj/ToggleBlock,/turf,/area)
"i" = (/obj/ToggleBlock{tag = "icon-On"; icon_state = "On"},/turf,/area)
"j" = (/obj/Collectible/Emerald,/turf,/area)
"k" = (/obj/Brick,/turf,/area)
"l" = (/obj/Hazard/Spikes/Acidblock,/turf,/area)
"m" = (/obj/Platform,/turf,/area)
"n" = (/obj/Checkpoint,/turf,/area)
"o" = (/obj/OneWayBlock{tag = "icon-OneWay"; icon_state = "OneWay"; dir = 2},/turf,/area)
"p" = (/obj/PlayerStart,/turf,/area)
"q" = (/obj/Brick/BrickTop,/obj/Conveyor/West,/turf,/area)
"r" = (/obj/Brick/BrickTop,/obj/Conveyor,/turf,/area)
"s" = (/obj/Hazard/Spikes,/turf,/area)
"t" = (/mob/FlierHorizontal,/turf,/area)
"u" = (/obj/Brick/Cracked,/turf,/area)
"v" = (/obj/Hazard/DeepPit,/turf,/area)
"w" = (/obj/Hazard/DeepPit/Hollow,/turf,/area)

(1,1,1) = {"
aaaaaaaaaaaaaaaaaaaaaaaaaaaaaaaaaaaaaaaaaaaaaaaaaaaaaaaaaaaaaaaaaaaaaaaaaaaaaaaaaaaaaaaaaa
aaaaaaaaaaaaaaaaaaaaaaaaaaaaaaaaaaaaaaaaaaaaaaaaaaaaaaaaaaaaaaaaaaaaaaaaaaaaaaaaaaaaaaaaaa
aaaaaaaaaaaaaaaaaaaaaaaaaaaaaaaaaaaaaaaaaaaaaaaaaaaaaaaaaaaaaaaaaaaaaaaaaaaaaaaaaaaaaaaaaa
aaaaaaaaaaaaaaaaaaaaaaaaaaaaaaaaaaaaaaaaaaaaaaaaaaaaaaaaaaaaaaaaaaaaaaaaaaaaaaaaaaaaaaaaaa
aaaaaaaaaaaaaaaaaaaaaaaaaaaaaaaaaaaaaaaaaaaaaaaaaaaaabaaaaaaaaaaaaaaaaaaaaaaaaaaaaaaaaaaaa
aaaaaaaaaaaaaaaaaaaaaaaaaaaaaaaaaaaaaaaaaaaaaaaaaaaaacccccaaaaaaaaaaaaaaaaaaaaaaaaaaaaaaaa
aaaaaaaaaaadaaaadaadaaaaaaaaaaaaaaaaaaaaaaaeeeaaaaaaaaaaaaaaaaaaaaaaaaaaaaaaaaaaaaaaaaaaaa
aaaaaaaaaaaaaaaaaaaaaaaaaaaaaaaaaaaaaaaaaaaaaaaaaaaaaaaaaaaaaaaaaaaaaaaaaaaaaaaaaaaaaaaaaa
aaaaaaaaaaaaaaaaaaaaaaaaaaaaaaaeeeaaaeeeaaaaaaaaaaaaaaaaaaccccaaaaaaaaaaaaaaaaaaaaaaaaaaaa
afaagaaahhaaaiiaahaaaiiiaaaaaaaaaaaaaaaaaaaaaaaaaaaaaaaaaaaaaeaeaaaaaaaaaaaaaaaaaaaaaaaaaa
aaajajaaaaaaaaaaaaaaaaaaaaaaaaaaaaaaaaaaaaaaaaaaaaaaaaaaaaaaakakaaaaaaaaaaaaaaaaaaaaaaaaaa
aajaaajaaaaaaaaaaaaaaaaaeeaaeeeaaaaaaaaaaaaaaaaaaaaaalladaaaakakaaaaaaaaaaaaaaaaaaaaaaaaaa
aagggggmmgaaaaaaaaaaaaaakkaaaaaaaaaaaaaaaaaaaaaaaanaaaaaaaaaakokaaaaaaaaaaaaaaaaaaaaaaaaaa
aaaaaaafaaaaadaaaaaaaaaakkaaaaaaaaaaeeeaaaaaaaaaaaeaaaaapaaaaaaaaaaaaaaaaaaaaaaaaaaaaaaaaa
aaaaaaaaaaaaaaaaaaaaaaaakkaaaaeeeeaaaaaaaaaaaaaaeekeqqqqerrrreaeeeeeeeeaaaaaaaaaaaaaaaaaaa
aaaaaaaaaaaaaaaaaaaaaaaakkaaaaaaaaaaaaaaaeeeeaaakkkkkkkkkkkkkkskkkkkkkkaaaaaaaaaaaaaaaaaaa
eeeeeeeerrreeeeaaakaakkkkkaaaaaaataaaaaaaaaaaaaakkkkkkkkkkkkkkekkkkkkkkaaaaaaaaaaaaaaaaaaa
kkkkkkkukkkkkukaaakaakkkkkvvvvvvvvvvvvvvvvvvvvvvkkkkkkkkkkkkkkekkkkkkkkaaaaaaaaaaaaaaaaaaa
kukkkkkkkkkkkkkvvvkvvkkkkkwwwwwwwwwwwwwwwwwwwwwwkkkkkkkkkkkkkkkkkkkkkkkaaaaaaaaaaaaaaaaaaa
"}
