"aa" = (/turf/Nothing,/area)
"ab" = (/obj/Autojoin/GrassCliff,/turf/Nothing,/area)
"ac" = (/obj/Autojoin/GrassCliff,/obj/Autojoin/SigmaPlatform/Pipe,/turf/Nothing,/area)
"ad" = (/obj/Autojoin/GrassCliff,/obj/Autojoin/BackgroundGrassCliff,/turf/Nothing,/area)
"ae" = (/obj/Autojoin/GrassCliff,/obj/Autojoin/BackgroundGrassCliff,/obj/Autojoin/SigmaPlatform/Pipe,/turf/Nothing,/area)
"af" = (/obj/Autojoin/BackgroundGrassCliff,/turf/Nothing,/area)
"ag" = (/obj/Collectible/Emerald,/turf/Nothing,/area)
"ah" = (/obj/Autojoin/BackgroundGrassCliff,/obj/Autojoin/SigmaPlatform/Pipe,/turf/Nothing,/area)
"ai" = (/obj/Collectible/Powerup/Jump,/turf/Nothing,/area)
"aj" = (/obj/Autojoin/SigmaPlatform/Pipe,/turf/Nothing,/area)
"ak" = (/obj/Decorative/Grass,/turf/Nothing,/area)
"al" = (/obj/Decorative/Grass,/obj/Decorative/Flower,/turf/Nothing,/area)
"am" = (/obj/Autojoin/BackgroundGrassCliff,/obj/Decorative/Grass,/turf/Nothing,/area)
"an" = (/obj/Autojoin/BackgroundGrassCliff,/obj/Decorative/Grass,/obj/Decorative/Mushroom/Small,/turf/Nothing,/area)
"ao" = (/obj/Autojoin/BackgroundGrassCliff,/obj/Decorative/Grass,/obj/Autojoin/SigmaPlatform/Pipe,/turf/Nothing,/area)
"ap" = (/obj/Autojoin/BackgroundGrassCliff,/obj/Decorative/Grass,/obj/Decorative/Mushroom,/turf/Nothing,/area)
"aq" = (/obj/Brick/Cracked/Stone,/turf/Nothing,/area)
"ar" = (/obj/Decorative/Grass,/obj/Brick/Cracked/Stone,/turf/Nothing,/area)
"as" = (/obj/WoodBlock,/turf/Nothing,/area)
"at" = (/obj/PlayerStart,/turf/Nothing,/area)
"au" = (/obj/Autojoin/SigmaPlatform,/turf/Nothing,/area)
"av" = (/obj/Autojoin/SigmaPlatform,/obj/Decorative/Sigma1/Vent,/turf/Nothing,/area)
"aw" = (/obj/Autojoin/GrassCliff,/obj/Autojoin/SigmaPlatform,/turf/Nothing,/area)
"ax" = (/obj/Decorative/Grass,/obj/Autojoin/SigmaPlatform/Pipe,/turf/Nothing,/area)
"ay" = (/obj/OneWayBlock{tag = "icon-OneWay"; icon_state = "OneWay"; dir = 2},/turf/Nothing,/area)
"az" = (/obj/Autojoin/BackgroundGrassCliff,/obj/Collectible/Emerald,/turf/Nothing,/area)
"aA" = (/obj/Autojoin/GrassCliff,/obj/Autojoin/SigmaPlatform,/obj/Decorative/Sigma1/Vent,/turf/Nothing,/area)
"aB" = (/obj/Autojoin/GrassCliff,/obj/Autojoin/SigmaPlatform,/obj/Autojoin/SigmaPlatform/Pipe,/turf/Nothing,/area)
"aC" = (/obj/Autojoin/GrassCliff,/obj/Autojoin/SigmaPlatform,/obj/Decorative/Sigma1/Tech,/turf/Nothing,/area)
"aD" = (/obj/Autojoin/GrassCliff,/obj/Autojoin/SigmaPlatform,/obj/Autojoin/SigmaPlatform/Pipe{dir = 4},/turf/Nothing,/area)
"aE" = (/obj/Autojoin/GrassCliff,/obj/Autojoin/SigmaPlatform/Pipe{dir = 4},/turf/Nothing,/area)
"aF" = (/mob/IronCrate,/turf/Nothing,/area)
"aG" = (/obj/Autojoin/SigmaPlatform/Pipe{dir = 4},/turf/Nothing,/area)
"aH" = (/obj/Autojoin/BackgroundGrassCliff,/obj/Decorative/Grass,/mob/PlatformWalker,/turf/Nothing,/area)
"aI" = (/obj/Collectible/Emerald,/obj/Autojoin/BackgroundGrassCliff,/turf/Nothing,/area)
"aJ" = (/obj/Autojoin/BackgroundGrassCliff,/obj/Decorative/Mushroom,/obj/Autojoin/SigmaPlatform/Pipe,/turf/Nothing,/area)
"aK" = (/obj/Autojoin/BackgroundGrassCliff,/obj/Decorative/Mushroom/Small,/turf/Nothing,/area)
"aL" = (/obj/Autojoin/BackgroundGrassCliff,/obj/Decorative/Mushroom,/turf/Nothing,/area)
"aM" = (/obj/Water/Surface,/turf/Nothing,/area)
"aN" = (/obj/Water,/turf/Nothing,/area)
"aO" = (/obj/Hazard/Spikes,/turf/Nothing,/area)
"aP" = (/obj/Autojoin/BackgroundGrassCliff,/obj/Water,/turf/Nothing,/area)
"aQ" = (/obj/Water,/mob/IronCrate,/turf/Nothing,/area)
"aR" = (/obj/Autojoin/BackgroundGrassCliff,/obj/Water,/mob/IronCrate,/turf/Nothing,/area)
"aS" = (/obj/Bridge/End{tag = "icon-RailingEnd (WEST)"; icon_state = "RailingEnd"; dir = 8},/turf/Nothing,/area)
"aT" = (/obj/Bridge/Railing,/turf/Nothing,/area)
"aU" = (/obj/Bridge,/turf/Nothing,/area)
"aV" = (/obj/Decorative/Grass,/mob/PlatformWalker,/turf/Nothing,/area)
"aW" = (/obj/Decorative/Grass,/obj/Bridge/End{tag = "icon-RailingEnd (EAST)"; icon_state = "RailingEnd"; dir = 4},/mob/Squishy,/turf/Nothing,/area)
"aX" = (/obj/Decorative/Flower,/obj/Decorative/Grass,/turf/Nothing,/area)
"aY" = (/obj/Water,/obj/Water/Surface,/turf/Nothing,/area)
"aZ" = (/obj/Water,/obj/Brick/Cracked/Stone,/turf/Nothing,/area)
"ba" = (/obj/Platform,/turf/Nothing,/area)
"bb" = (/obj/Hazard/Spikes,/obj/Water/Surface,/turf/Nothing,/area)
"bc" = (/obj/Hazard/Spikes,/obj/Water,/turf/Nothing,/area)
"bd" = (/obj/Autojoin/SigmaPlatform,/obj/Decorative/Sigma1/Tech,/turf/Nothing,/area)
"be" = (/obj/Hazard/Lava,/turf/Nothing,/area)
"bf" = (/obj/Hazard/Lava/Deep,/turf/Nothing,/area)

(1,1,1) = {"
aaaaaaaaaaaaaaaaaaaaaaaaaaaaaaaaaaaaaaaaaaaaaaaaaaaaaaaaaaaaaaaaaaaaaaaaaaaaababababababacabacabacababaaaaaaaaaaaaaaaaaaaaaaaaaaaaaaaaaaabab
aaaaaaaaaaaaaaaaaaaaaaaaaaaaaaaaaaaaaaaaaaaaaaaaaaaaaaaaaaaaaaaaaaaaaaaaaaaaaaaaaaabadadaeadaeadaeadadafafafaaaaaaaaaaaaaaagaaaaaaaaaaaaabab
abaaaaaaaaaaaaaaaaaaaaaaaaaaaaaaaaaaaaaaaaaaaaaaaaaaaaaaaaaaaaaaaaaaaaaaaaaaaaaaaaaaafafahafahafahafafafafafaaaaaaagaaaaaaaiaaaaaaagaaaaabab
abaaaaaaaaaaaaaaaaaaaaaaaaaaaaaaaaaaajaaaaaaaaaaaaaaaaaaaaaaaaaaaaaaaaaaaaaaaaaaaaaaafafahafahafahafafafafafaaaaaaaaaaaaaaaaaaaaaaaaaaaaabab
abaaaaaaaaaaaaaaaaaaaaaaaaaaaaaaaaaaajaaaaaaaaaaagagaaaaaaaaaaaaaaaaaaaaaaaaaaaaaaaaafafahafafafahafafafafafafaaaaaaaaaaaaaaaaaaaaaaaaakabab
abaaaaaaaaaaaaaaaaaaaaaaaaaaaaaaaaaaajaaaaaaaaaaaaaaaaaaaaaaaaaaaaaaaaaaaaaaaaakalamamanaoamanapaoamamamanamamakalakakakaqaqaqakakalakababab
abaaaaaaaaaaaaaaaaaaaaaaaaaaaaaaaaaaajaaaaaaaaaaaaaaaaaaaaaaakakakakakarakakakababadadadaeadadadaeadadadadadadababababababababababababababab
abaaaaaaaaaaaaaaaaaaaaaaagaaaaaaaaaaajaaagaaaaaaasasaaaaaaaaababababababababababababababacabababacababababababababababababababababababababab
ababagaaaaaaaaaaaaaaaaaaaaaaaaaaaaaaajaaaaaaaaaaaaaaaaaaaaaaababababababababababababababacababababababababababababababababababababababababab
ababaaaaaaaaataaaaaaaaaaaaaaaaaaaaaaajaaasaaaaaaaaaaaaaaaaaaabababababababababababababababababababababababababababababababababababababababab
ababakakakauavauakakakalakarakakaaaaajaaaaaaagaaagaaaaaaaaaaabababababababababababababababababababababababababababababababababababababababab
abababababawawawababababababababakakajaaaaaaaaaaaaaaaaakarakabababababababababababababababababababababababababababababababababababababababab
ababababababababababababababababababaxakalakakakaaagaaababababababababababababababababababababababababababababababababababababababababababab
abababababacababababababababababababacabababababayayayababababababababababababababababababababababababababababababababababababababababababab
abababababacababababawawawawawawawabacabababadadafazafadadababababababababababababababababababababababababababababababababababababababababab
abababababacababababawaAaBaCaDaAawabacabababadadafafafadadababababababababababababababababababababababababababababababababababababababababab
abababababacababababawaAaBaCaDaAawabacabababadadafazafadadababababababababababababababababababababababababababababababababababababababababab
abababababacababababawawawawawawawabababababadadafafafadadababababababababababababababababababababababababababababababababababababababababab
abababababacababababababababababababababababadafafazafafadababababababababababababababababababababababababaEabababababababababababababababab
ababababababababababababababababababababababadafafafafafadabaFababababababababababababababababababababababaEabababababababababababababababab
ababababababababababababababababababababababadafafazafafadabaFababababababababababababababababababababababaEabababababababababababababababab
abababababababababababababababababababadadadadafafafafafadadadababababababababababababababababababababaaaaaGaaaaaaaaaaaaaaaaaaaaaaaaaaaaaaaa
abababababababababababababababababaFaFadadadafafafazafafafadadababababababababababababababababababababaaaaaGaaaaaaaaaaaaaaaaaaaaaaaaaaaaaaaa
abababababababababababababababababaFabadadafafafafafafafafadadabababababababababababababaaaaaaaaaaaaaaaaaaaGaaaaaaaaaaaaaaaaaaaaaaaaaaaaaaaa
abababababababababababababababababaFabadafafafafafazafafafadadabababababababababababababaaaaaaaaaaaaaaaaaaaGaaaaaaaaaaaaaaaaaaaaaaaaaaaaaaaa
abababababababababababababababababababadafafafafafafafafafafadababababababababababaaaaaaaaaaaaaFaaaaaaaaaaaGaaaaaaaaaaaaaaaaaaaaaaaaaaaaaaaa
abababababababababababababababababababadafafafafafafafafafafadabababababacababacabaaaaaaaaaaaaabaaaaaaaaaaaGaaaaaaaaaaaaaaaaaaaaaaaaaaaaaaaa
ababababababababababababababababacabadadafafafafafafafafafafadadadadadadaeadadaeabaaaaaaaaaaaaabaaaaaaaaaaaGaaaaaaaaaaaaaaaaaaaaaaaaaaaaaaaa
abababadadadadadababadadadabababaeadadadafaaaaaaafafafaaaaaaabadafafafafahazafahaaaaaaaaaaaaaaabaaaaaaaaaaaGaaaaaaaaaaaaaaaaaaaaaaaaaaaaaaaa
aaaaaaafafafafafaaaaafafaaaaaaaaahafafafafaaaaaaafafafaaaaaaaaaaaaafazamaoaHamaoakakakakalakakabaaaaaaaaaaaGaaaaaaaaaaaaaaaaaaaaaaaaaaaaaaaa
aaaaaaafafaaafafaaaaafafaaaaaaaaahafafafaaaaaaaaafaIaaaaaaaaaaagaaaaafadaeadadaeabababababababacaaaaaaaaaaaGaaaaaaaaaaaaaaaaaaaaaaaaaaaaaaaa
aaaaaaafafaaafafaaaaafaaaaaaaaaaahafafafaaaaaaaaaaafaaaaaaaaaaaaaaaaaaabacababacabababababaaaaajaaaaaaaaaaaGaaaaaaaaaaaaaaaaaaaaaaaaaaaaaaaa
aaaaaaafafaaaaafaaaaafaaaaaaaaaaahafazafaaaaaaagaaafaaagaaaaaaaaaaaaabababababababaaaaaaaaaaaaajaaaaaaaaaaaGaaaaaaaaaaaaaaaaaaaaaaaaaaaaaaaa
aaaaaaafaaaaaaaaaaaaafaaaaaaaaaaaJaKaLaKakaaaaaaaaaaaaaaaaaaaaaaaaababababababababaaaaaaaaaaaaajaaaaaaaaaaaGaaaaaaaaaaaaaaaaaaaaaaaaaaaaaaaa
aaaaaaafaaaaaaaaaaaaafaaagaaaaaaaeadadadabaMaMaMaMaMaMaMaMaMaMaMaMabababababababaaaaaaaaaaaaaaajaaaaaaaaaaaGaaaaaaaaaaaaaaaaaaaaaaaaaaaaaaaa
aaaaaaaaaaaaaaaaaaaaaaaaaaaaaaabacababababaNaNaNaNaNaNaNaNaNaNaNaNababababababaaaaaaaaaaaaaaaaajaaaaaaaaaaaGaaaaaaaaaaaaaaaaaaaaaaaaaaaaaaaa
aaaaaaaaaaaaaaaaagaaaaaaaaaOaOabababababababaNaNaNaNaNaNaNaNaNaNaPadadadadabaaaaaaaaaaaaaaaaabacabababababaEaqaaaaaaaaaaaaaaaaaaaaaaaaaaaaaa
aaaaaaaaaaaaaaaaaaaaaaaaaaabababababababababaNaQaNaNaNaNaNaNaNaNaPaPaRaPaPaNaaaaaaaaaaaaaaaaabababababababaEabababaaaaaaaaaaaaaaaaaaaaaaaaaa
aaaaaaaaaaaaaaaaaaaaababababababababababababababababababababababadadadadadaNaaaaaaaaaaaaaSaTabababaaaaababaEabababaaaaaaaaaaaaaaaaaaaaaaaaaa
aaaaaaaaaaaaaaaaaaaaacababababababababababababababababababababababababadabaNaaaaaaaaaaaaasaUababaaaaaaaaabababababaaaaaaaaaaaaaaaaaaaaaaaaaa
aaaaaaaaaaaaaaaaaaaaajabababababababababababababababababababababadababadaaaNaaaaaaaaaaaaaaaaababaaaaaaaaabababababaaaaaaaaaaaaaaaaaaaaaaaaaa
aaaaaaaaaaaaagaaaaaaajaaaaaaaaababadadadadadabababababababadababafaaaaafaaaNaaaaaaaSaTaTaTaTabaaaaaaaaaaaaaaabababaaaaaaaaaaaaaaaaaaaaaaaaaa
aaaaaaakaVarakaaaaagajaaaaaaaaaaaaaaafafafaaaaabadabababaaafaaaaafaaaaaaaaaNaaaaaaasaUaUaUaUabaaaaaaaaaaaaaaabababaaaaaaaaaaaaaaaaaaaaaaaaaa
abababababababakakalaxakaaaaaaaaaaaaafaIaaaaaaagafaaaaaaaaafaaaaafaaaaaaaaaNaaaaaaaaaaaaaaaaaaaaaaaaaaaaaaaaaaababaaaaaaaaaaaaaaaaaaaaaaaaaa
abaaababababababababacabakalaaaaaaagaaaaaaagaaaaafagaaaaaaaaaaaaaaaaaaaaaaaNaaaaaaaaaaaaaaaaaaaaaaaaaaaaaaaaaaabaaaaaaaaaaaaaaaaaaaaaaaaaaaa
aaaaaaabaaabababababababababaTaTaTaTaTaTaTaTaTaTaTaTaTaTaTaTaTaWaXaaaaaaaaaNaaaaaaaaakakaaaaaaaaaaaaaaaaaiaaaaabaaaaaaaaaaaaaaaaaaaaaaaaaaaa
aaaaaaaaaaabababababababababaUaUaUaUaUaUaUaUaUaUaUaUaUaUaUaUaUababaMaMaMaMaYaMaMaMaMababaaaaaaaaaaaaaaaaaaaaaaaaaaaaaaaaaaaaaaaaaaaaaaaaaaaa
aaaaaaaaaaaaaaaaaaaaaaaaaaaaaaaaaaaaaaaaaaaaaaaaaaaaaaaaaaaaaaabababaNaNaNaNaNaNaNaNababaaaaaaaaaaaaaaaaaaaaaaaaaaaaaaaaaaaaaaaaaaaaaaaaaaaa
aaaaaaaaaaaaaaaaaaaaaaaaaaaaaaaaaaaaaaaaaaaaaaaaaaaaaaaaaaaaaaabababaNaNaNaNaNaZaZaNababaaasbababababaasaaaaaaaaaaaaaaaaaaaaaaaaaaaaaaaaaaaa
aaaaaaaaaaaaaaaaaaaaaaaaaaaaaaaaaaaaaaaaaaaaaaaaaaaaaaaaaaaaaaabababababababababababababaaaaaaaaaaaaaaaaaaaaaaaaaaaaaaaaaaaaaaaaaaaaaaaaaaaa
aaaaaaaaaaaaaaaaaaaaaaaaaaaaaaaaaaaaaaaaaaaaaaaaaaaaaaaaaaaaaaabababababababababacabababaaaaaaaaaaaaaaaaaaaaaaaaaaaaaaaaaaaaaaaaaaaaaaaaaaaa
aaaaaaaaaaaaaaaaaaaaaaaaaaaaaaaaaaaaaaaaaaaaaaaaaaaaaaaaaaaaaaaaaaaaaaaaaNaaaaaaajaaaaaaaaaaaaaaaaaaaaaaaaaaaaaaaaaaaaaaaaaaaaaaaaaaaaaaaaaa
aaaaaaaaaaaaaaaaaaaaaaaaaaaaaaaaaaaaaaaaaaaaaaaaaaaaaaaaaaaaaaaaaaaaaaaaaNaaaaaaajaaaaaaaaaaaaaaaaaaaaaaaaaaaaaaaaaaaaaaaaaaaaaaaaaaaaaaaaaa
aaaaaaaaaaaaaaaaaaaaaaaaaaaaaaaaaaaaaaaaaaaaaaaaaaaaaaaaaaaaaaaaaaaaaaaaaNaaaaaaajaaaaaaaaaaaaaaaaaaaaaaaaaaaaaaaaaaaaaaaaaaaaaaaaaaaaaaaaaa
aaaaaaaaaaaaaaaaaaaaaaaaaaaaaaaaaaaaaaaaaaaOaOaaaaaaaaaaaaaaaaaaaaaaaaaaaNaaaaaaajaaaaaaaaaaaaaaaaaaaaaaaaaaaaaaaaaaaaaaaaaaaaaaaaaaaaaaaaaa
aaaaaaaaaaaaaaaaaaaaaaaaaaaaaaaaaaaaaaaaaaababaaaaaaaaaaaaaaaaaaaaaaaaaaaNaaaaaaajaaaaaaaaaaaaaaaaaaaaaaaaaaaaaaaaaaaaaaaaaaaaaaaaaaaaaaaaaa
aaaaaaaaaaaaaaaaaaaaaaaaaaaaaaaaaaaaaOaaaaababaaaaaaaaaaaaaaaaaaaaaaaaaaaNaaaaaaajaaaaaaaaaaaaaaaaaaaaaaaaaaaaaaaaaaaaaaaaaaaaaaaaaaaaaaaaaa
aaaaaaaaaaaaaaaaaaaaaaaaaaaaaaaOaOaOabaaaaababaaaaaaaaaaaaaaaaaaaaaaaaaaaNaaaaaOajaaaaaaaaaaaaaaaaaaaaaaaaaaaaaaaaaaaaaaaaaaaaaaaaaaaaaaaaaa
aaaaaaaaaaaaaaaaaaaaaaaaaaaaaaababababaaaOababaOaaaaaaaaaaaaaaaaaaaaaaaaaNaaaaabacabaaaaaaaaaaaaaaaaaaaaaaaaaaaaaaaaaaaaaaaaaaaaaaaaaaaaaaaa
aaaaaaaaaaaaaaaaaaaaaaaaaaaaaaababababaOababababaaaaaaaOaaaaaaaaaaaOaaaaaNaaaaabacabaaaaaaaaaaaaaaaaaaaaaaaaaaaaaaaaaaaaaaaaaaaaaaaaaaaaaaaa
aaaaaaaaaaaaaaaaaaaaaaaaaaaaaaabadadababadadadadaOaOaaabaaaaaaaaaOabaOaaaNaaaOabababaaaaaaaaaaaaaaaaaaaaaaaaaaaaaaaaaaaaaaaaaaaaaaaaaaaaaaaa
aaaaaaaaaaaaaaaaaaaaaaaaaaaaaaabadadabadadafafadababaOabaOaaaaaOabababbbaYaMabadadabaaaaaaaaaaaaaaaaaaaaaaaaaaaaaaaaaaaaaaaaaaaaaaaaaaaaaaaa
aaaaaaaaaaaaaaaaaaaaaaaaaaaaaaaaadadadadafafafadadadadadabaaaaabadadadabaNaOabadafaaaaaaaaaaaaaaaaaaaaaaaaaaaaaaaaaaaaaaaaaaaaaaaaaaaaaaaaaa
aaaaaaaaaaaaaaaaaaaaaaaaaaaaaaaaafafafafafafafafafadadadabaaaaaaafafadabbcababadafafaaaaaaaaaaaaaaaaaaaaaaaaaaaaaaaaaaaaaaaaaaaaaaaaaaaaaaaa
aaaaaaaaaaaaaaaaaaaaaaaaaaaaaaaaafafafafafafafafafafafafaaaaaaaaaaafafadadadadafafafaaaaaaaaaaaaaaaaaaaaaaaaaaaaaaaaaaaaaaaaaaaaaaaaaaaaaaaa
aaaaaaaaaaaaaaaaaaaaaaaaaaaaaaaaafafafafafafafafafafafafaaaaaaaaaaafafafafafafafafafaaaaaaaaaaaaaaaaaaaaaaaaaaaaaaaaaaaaaaaaaaaaaaaaaaaaaaaa
aaaaaaaaaaaaaaaaaaaaaaaaaaaaaaabadadafafafafafadadadadadabaaaaaaaaaaafafafafafafafafaaaaaaaaaaaaaaaaaaaaaaaaaaaaaaaaaaaaaaaaaaaaaaaaaaaaaaaa
aaaaaaaaauauauauauauauaOauauaaabadadadadadadadadadadadadaaaaaaaaaaaaaaaaaaaaaaaaaaaaaaaaaaaaaaaaaaaaaaaaaaaaaaaaaaaaaaaaaaaaaaaaaaaaaaaaaaaa
aaaaaaaaaubdavbdavbdauaaauauaOababababababababababaaaaaaaaaaaaaaaaaaaaaaaaaaaaaaaaaaaaaaaaaaaaaaaaaaaaaaaaaaaaaaaaaaaaaaaaaaaaaaaaaaaaaaaaaa
auauaaaaauauauauauauauaaauauaaaaababababaaaaaaaaaaaaaaaaaaaaaaaaaaaaaaaaaaaaaaaaaaaaaaaaaaaaaaaaaaaaaaaaaaaaaaaaaaaaaaaaaaaaaaaaaaaaaaaaaaaa
auauaaaaaaaaaaaaaaaaaaaaaaaaaaaaaaaaaaaaaaaaaaaaaaaaaaaaaaaaaaaaaaaaaaaaaaaaaaaaaaaaaaaaaaaaaaaaaaaaaaaaaaaaaaaaaaaaaaaaaaaaaaaaaaaaaaaaaaaa
auauaaaaaaaaaaaaaaaaaaaaaaaaaaaaaaaaaaaaaaaaaaaaaaaaaaaaaaaaaaaaaaaaaaaaaaaaaaaaaaaaaaaaaaaaaaaaaaaaaaaaaaaaaaaaaaaaaaaaaaaaaaaaaaaaaaaaaaaa
auauaaauauaaaaaaaaaaaaaaaaaaaaaaaaaaaaaaaaaaaaaaaaaaaaaaaaaaaaaaaaaaaaaaaaaaaaaaaaaaaaaaaaaaaaaaaaaaaaaaaaaaaaaaaaaaaaaaaaaaaaaaaaaaaaaaaaaa
aaaaaaauauaaaaaaaaaaaaaaaaaaaaaaaaaaaaaaaaaaaaaaaaaaaaaaaaaaaaaaaaaaaaaaaaaaaaaaaaaaaaaaaaaaaaaaaaaaaaaaaaaaaaaaaaaaaaaaaaaaaaaaaaaaaaaaaaaa
aaaaaaaaaaaaaaaaaaaaaaaaaaaaaaaaaaaaaaaaaaaaaaaaaaaaaaaaaaaaaaaaaaaaaaaaaaaaaaaaaaaaaaaaaaaaaaaaaaaaaaaaaaaaaaaaaaaaaaaaaaaaaaaaaaaaaaaaaaaa
aaaaaaaaaaaaaaaaaaaaaaaaaaaaaaaaaaaaaaaaaaaaaaaaaaaaaaaaaaaaaaaaaaaaaaaaaaaaaaaaaaaaaaaaaaaaaaaaaaaaaaaaaaaaaaaaaaaaaaaaaaaaaaaaaaaaaaaaaaaa
bebebebeauauauauaubebebebebeauauauauauauaaaaaaaaaaaaaaaaaaaaaaaaaaaaaaaaaaaaaaaaaaaaaaaaaaaaaaaaaaaaaaaaaaaaaaaaaaaaaaaaaaaaaaaaaaaaaaaaaaaa
bfbfbfbfauauauauaubfbfbfbfbfauauauauauauaaaaaaaaaaaaaaaaaaaaaaaaaaaaaaaaaaaaaaaaaaaaaaaaaaaaaaaaaaaaaaaaaaaaaaaaaaaaaaaaaaaaaaaaaaaaaaaaaaaa
aaaaaaaaaaaaaaaaaaaaaaaaaaaaaaaaaaaaaaaaaaaaaaaaaaaaaaaaaaaaaaaaaaaaaaaaaaaaaaaaaaaaaaaaaaaaaaaaaaaaaaaaaaaaaaaaaaaaaaaaaaaaaaaaaaaaaaaaaaaa
aaaaaaaaaaaaaaaaaaaaaaaaaaaaaaaaaaaaaaaaaaaaaaaaaaaaaaaaaaaaaaaaaaaaaaaaaaaaaaaaaaaaaaaaaaaaaaaaaaaaaaaaaaaaaaaaaaaaaaaaaaaaaaaaaaaaaaaaaaaa
aaaaaaaaaaaaaaaaaaaaaaaaaaaaaaaaaaaaaaaaaaaaaaaaaaaaaaaaaaaaaaaaaaaaaaaaaaaaaaaaaaaaaaaaaaaaaaaaaaaaaaaaaaaaaaaaaaaaaaaaaaaaaaaaaaaaaaaaaaaa
aaaaaaaaaaaaaaaaaaaaaaaaaaaaaaaaaaaaaaaaaaaaaaaaaaaaaaaaaaaaaaaaaaaaaaaaaaaaaaaaaaaaaaaaaaaaaaaaaaaaaaaaaaaaaaaaaaaaaaaaaaaaaaaaaaaaaaaaaaaa
aaaaaaaaaaaaaaaaaaaaaaaaaaaaaaaaaaaaaaaaaaaaaaaaaaaaaaaaaaaaaaaaaaaaaaaaaaaaaaaaaaaaaaaaaaaaaaaaaaaaaaaaaaaaaaaaaaaaaaaaaaaaaaaaaaaaaaaaaaaa
aaaaaaaaaaaaaaaaaaaaaaaaaaaaaaaaaaaaaaaaaaaaaaaaaaaaaaaaaaaaaaaaaaaaaaaaaaaaaaaaaaaaaaaaaaaaaaaaaaaaaaaaaaaaaaaaaaaaaaaaaaaaaaaaaaaaaaaaaaaa
aaaaaaaaaaaaaaaaaaaaaaaaaaaaaaaaaaaaaaaaaaaaaaaaaaaaaaaaaaaaaaaaaaaaaaaaaaaaaaaaaaaaaaaaaaaaaaaaaaaaaaaaaaaaaaaaaaaaaaaaaaaaaaaaaaaaaaaaaaaa
aaaaaaaaaaaaaaaaaaaaaaaaaaaaaaaaaaaaaaaaaaaaaaaaaaaaaaaaaaaaaaaaaaaaaaaaaaaaaaaaaaaaaaaaaaaaaaaaaaaaaaaaaaaaaaaaaaaaaaaaaaaaaaaaaaaaaaaaaaaa
aaaaaaaaaaaaaaaaaaaaaaaaaaaaaaaaaaaaaaaaaaaaaaaaaaaaaaaaaaaaaaaaaaaaaaaaaaaaaaaaaaaaaaaaaaaaaaaaaaaaaaaaaaaaaaaaaaaaaaaaaaaaaaaaaaaaaaaaaaaa
aaaaaaaaaaaaaaaaaaaaaaaaaaaaaaaaaaaaaaaaaaaaaaaaaaaaaaaaaaaaaaaaaaaaaaaaaaaaaaaaaaaaaaaaaaaaaaaaaaaaaaaaaaaaaaaaaaaaaaaaaaaaaaaaaaaaaaaaaaaa
aaaaaaaaaaaaaaaaaaaaaaaaaaaaaaaaaaaaaaaaaaaaaaaaaaaaaaaaaaaaaaaaaaaaaaaaaaaaaaaaaaaaaaaaaaaaaaaaaaaaaaaaaaaaaaaaaaaaaaaaaaaaaaaaaaaaaaaaaaaa
aaaaaaaaaaaaaaaaaaaaaaaaaaaaaaaaaaaaaaaaaaaaaaaaaaaaaaaaaaaaaaaaaaaaaaaaaaaaaaaaaaaaaaaaaaaaaaaaaaaaaaaaaaaaaaaaaaaaaaaaaaaaaaaaaaaaaaaaaaaa
aaaaaaaaaaaaaaaaaaaaaaaaaaaaaaaaaaaaaaaaaaaaaaaaaaaaaaaaaaaaaaaaaaaaaaaaaaaaaaaaaaaaaaaaaaaaaaaaaaaaaaaaaaaaaaaaaaaaaaaaaaaaaaaaaaaaaaaaaaaa
aaaaaaaaaaaaaaaaaaaaaaaaaaaaaaaaaaaaaaaaaaaaaaaaaaaaaaaaaaaaaaaaaaaaaaaaaaaaaaaaaaaaaaaaaaaaaaaaaaaaaaaaaaaaaaaaaaaaaaaaaaaaaaaaaaaaaaaaaaaa
aaaaaaaaaaaaaaaaaaaaaaaaaaaaaaaaaaaaaaaaaaaaaaaaaaaaaaaaaaaaaaaaaaaaaaaaaaaaaaaaaaaaaaaaaaaaaaaaaaaaaaaaaaaaaaaaaaaaaaaaaaaaaaaaaaaaaaaaaaaa
aaaaaaaaaaaaaaaaaaaaaaaaaaaaaaaaaaaaaaaaaaaaaaaaaaaaaaaaaaaaaaaaaaaaaaaaaaaaaaaaaaaaaaaaaaaaaaaaaaaaaaaaaaaaaaaaaaaaaaaaaaaaaaaaaaaaaaaaaaaa
aaaaaaaaaaaaaaaaaaaaaaaaaaaaaaaaaaaaaaaaaaaaaaaaaaaaaaaaaaaaaaaaaaaaaaaaaaaaaaaaaaaaaaaaaaaaaaaaaaaaaaaaaaaaaaaaaaaaaaaaaaaaaaaaaaaaaaaaaaaa
aaaaaaaaaaaaaaaaaaaaaaaaaaaaaaaaaaaaaaaaaaaaaaaaaaaaaaaaaaaaaaaaaaaaaaaaaaaaaaaaaaaaaaaaaaaaaaaaaaaaaaaaaaaaaaaaaaaaaaaaaaaaaaaaaaaaaaaaaaaa
aaaaaaaaaaaaaaaaaaaaaaaaaaaaaaaaaaaaaaaaaaaaaaaaaaaaaaaaaaaaaaaaaaaaaaaaaaaaaaaaaaaaaaaaaaaaaaaaaaaaaaaaaaaaaaaaaaaaaaaaaaaaaaaaaaaaaaaaaaaa
aaaaaaaaaaaaaaaaaaaaaaaaaaaaaaaaaaaaaaaaaaaaaaaaaaaaaaaaaaaaaaaaaaaaaaaaaaaaaaaaaaaaaaaaaaaaaaaaaaaaaaaaaaaaaaaaaaaaaaaaaaaaaaaaaaaaaaaaaaaa
aaaaaaaaaaaaaaaaaaaaaaaaaaaaaaaaaaaaaaaaaaaaaaaaaaaaaaaaaaaaaaaaaaaaaaaaaaaaaaaaaaaaaaaaaaaaaaaaaaaaaaaaaaaaaaaaaaaaaaaaaaaaaaaaaaaaaaaaaaaa
aaaaaaaaaaaaaaaaaaaaaaaaaaaaaaaaaaaaaaaaaaaaaaaaaaaaaaaaaaaaaaaaaaaaaaaaaaaaaaaaaaaaaaaaaaaaaaaaaaaaaaaaaaaaaaaaaaaaaaaaaaaaaaaaaaaaaaaaaaaa
aaaaaaaaaaaaaaaaaaaaaaaaaaaaaaaaaaaaaaaaaaaaaaaaaaaaaaaaaaaaaaaaaaaaaaaaaaaaaaaaaaaaaaaaaaaaaaaaaaaaaaaaaaaaaaaaaaaaaaaaaaaaaaaaaaaaaaaaaaaa
aaaaaaaaaaaaaaaaaaaaaaaaaaaaaaaaaaaaaaaaaaaaaaaaaaaaaaaaaaaaaaaaaaaaaaaaaaaaaaaaaaaaaaaaaaaaaaaaaaaaaaaaaaaaaaaaaaaaaaaaaaaaaaaaaaaaaaaaaaaa
aaaaaaaaaaaaaaaaaaaaaaaaaaaaaaaaaaaaaaaaaaaaaaaaaaaaaaaaaaaaaaaaaaaaaaaaaaaaaaaaaaaaaaaaaaaaaaaaaaaaaaaaaaaaaaaaaaaaaaaaaaaaaaaaaaaaaaaaaaaa
aaaaaaaaaaaaaaaaaaaaaaaaaaaaaaaaaaaaaaaaaaaaaaaaaaaaaaaaaaaaaaaaaaaaaaaaaaaaaaaaaaaaaaaaaaaaaaaaaaaaaaaaaaaaaaaaaaaaaaaaaaaaaaaaaaaaaaaaaaaa
aaaaaaaaaaaaaaaaaaaaaaaaaaaaaaaaaaaaaaaaaaaaaaaaaaaaaaaaaaaaaaaaaaaaaaaaaaaaaaaaaaaaaaaaaaaaaaaaaaaaaaaaaaaaaaaaaaaaaaaaaaaaaaaaaaaaaaaaaaaa
aaaaaaaaaaaaaaaaaaaaaaaaaaaaaaaaaaaaaaaaaaaaaaaaaaaaaaaaaaaaaaaaaaaaaaaaaaaaaaaaaaaaaaaaaaaaaaaaaaaaaaaaaaaaaaaaaaaaaaaaaaaaaaaaaaaaaaaaaaaa
aaaaaaaaaaaaaaaaaaaaaaaaaaaaaaaaaaaaaaaaaaaaaaaaaaaaaaaaaaaaaaaaaaaaaaaaaaaaaaaaaaaaaaaaaaaaaaaaaaaaaaaaaaaaaaaaaaaaaaaaaaaaaaaaaaaaaaaaaaaa
aaaaaaaaaaaaaaaaaaaaaaaaaaaaaaaaaaaaaaaaaaaaaaaaaaaaaaaaaaaaaaaaaaaaaaaaaaaaaaaaaaaaaaaaaaaaaaaaaaaaaaaaaaaaaaaaaaaaaaaaaaaaaaaaaaaaaaaaaaaa
aaaaaaaaaaaaaaaaaaaaaaaaaaaaaaaaaaaaaaaaaaaaaaaaaaaaaaaaaaaaaaaaaaaaaaaaaaaaaaaaaaaaaaaaaaaaaaaaaaaaaaaaaaaaaaaaaaaaaaaaaaaaaaaaaaaaaaaaaaaa
aaaaaaaaaaaaaaaaaaaaaaaaaaaaaaaaaaaaaaaaaaaaaaaaaaaaaaaaaaaaaaaaaaaaaaaaaaaaaaaaaaaaaaaaaaaaaaaaaaaaaaaaaaaaaaaaaaaaaaaaaaaaaaaaaaaaaaaaaaaa
aaaaaaaaaaaaaaaaaaaaaaaaaaaaaaaaaaaaaaaaaaaaaaaaaaaaaaaaaaaaaaaaaaaaaaaaaaaaaaaaaaaaaaaaaaaaaaaaaaaaaaaaaaaaaaaaaaaaaaaaaaaaaaaaaaaaaaaaaaaa
aaaaaaaaaaaaaaaaaaaaaaaaaaaaaaaaaaaaaaaaaaaaaaaaaaaaaaaaaaaaaaaaaaaaaaaaaaaaaaaaaaaaaaaaaaaaaaaaaaaaaaaaaaaaaaaaaaaaaaaaaaaaaaaaaaaaaaaaaaaa
aaaaaaaaaaaaaaaaaaaaaaaaaaaaaaaaaaaaaaaaaaaaaaaaaaaaaaaaaaaaaaaaaaaaaaaaaaaaaaaaaaaaaaaaaaaaaaaaaaaaaaaaaaaaaaaaaaaaaaaaaaaaaaaaaaaaaaaaaaaa
aaaaaaaaaaaaaaaaaaaaaaaaaaaaaaaaaaaaaaaaaaaaaaaaaaaaaaaaaaaaaaaaaaaaaaaaaaaaaaaaaaaaaaaaaaaaaaaaaaaaaaaaaaaaaaaaaaaaaaaaaaaaaaaaaaaaaaaaaaaa
aaaaaaaaaaaaaaaaaaaaaaaaaaaaaaaaaaaaaaaaaaaaaaaaaaaaaaaaaaaaaaaaaaaaaaaaaaaaaaaaaaaaaaaaaaaaaaaaaaaaaaaaaaaaaaaaaaaaaaaaaaaaaaaaaaaaaaaaaaaa
aaaaaaaaaaaaaaaaaaaaaaaaaaaaaaaaaaaaaaaaaaaaaaaaaaaaaaaaaaaaaaaaaaaaaaaaaaaaaaaaaaaaaaaaaaaaaaaaaaaaaaaaaaaaaaaaaaaaaaaaaaaaaaaaaaaaaaaaaaaa
aaaaaaaaaaaaaaaaaaaaaaaaaaaaaaaaaaaaaaaaaaaaaaaaaaaaaaaaaaaaaaaaaaaaaaaaaaaaaaaaaaaaaaaaaaaaaaaaaaaaaaaaaaaaaaaaaaaaaaaaaaaaaaaaaaaaaaaaaaaa
aaaaaaaaaaaaaaaaaaaaaaaaaaaaaaaaaaaaaaaaaaaaaaaaaaaaaaaaaaaaaaaaaaaaaaaaaaaaaaaaaaaaaaaaaaaaaaaaaaaaaaaaaaaaaaaaaaaaaaaaaaaaaaaaaaaaaaaaaaaa
aaaaaaaaaaaaaaaaaaaaaaaaaaaaaaaaaaaaaaaaaaaaaaaaaaaaaaaaaaaaaaaaaaaaaaaaaaaaaaaaaaaaaaaaaaaaaaaaaaaaaaaaaaaaaaaaaaaaaaaaaaaaaaaaaaaaaaaaaaaa
aaaaaaaaaaaaaaaaaaaaaaaaaaaaaaaaaaaaaaaaaaaaaaaaaaaaaaaaaaaaaaaaaaaaaaaaaaaaaaaaaaaaaaaaaaaaaaaaaaaaaaaaaaaaaaaaaaaaaaaaaaaaaaaaaaaaaaaaaaaa
"}
