"a" = (/turf/Nothing,/area)
"b" = (/obj/Autojoin/GrassCliff,/turf/Nothing,/area)
"c" = (/obj/Autojoin/GrassCliff,/obj/Autojoin/SigmaPlatform/Pipe,/turf/Nothing,/area)
"d" = (/obj/Autojoin/GrassCliff,/obj/Autojoin/BackgroundGrassCliff,/turf/Nothing,/area)
"e" = (/obj/Autojoin/GrassCliff,/obj/Autojoin/BackgroundGrassCliff,/obj/Autojoin/SigmaPlatform/Pipe,/turf/Nothing,/area)
"f" = (/obj/Autojoin/BackgroundGrassCliff,/turf/Nothing,/area)
"g" = (/obj/Collectible/Emerald,/turf/Nothing,/area)
"h" = (/obj/Autojoin/BackgroundGrassCliff,/obj/Autojoin/SigmaPlatform/Pipe,/turf/Nothing,/area)
"i" = (/obj/Autojoin/SigmaPlatform/Pipe,/turf/Nothing,/area)
"j" = (/obj/Decorative/Grass,/turf/Nothing,/area)
"k" = (/obj/Decorative/Grass,/obj/Decorative/Flower,/turf/Nothing,/area)
"l" = (/obj/Autojoin/BackgroundGrassCliff,/obj/Decorative/Grass,/turf/Nothing,/area)
"m" = (/obj/Autojoin/BackgroundGrassCliff,/obj/Decorative/Grass,/obj/Decorative/Mushroom/Small,/turf/Nothing,/area)
"n" = (/obj/Autojoin/BackgroundGrassCliff,/obj/Decorative/Grass,/obj/Autojoin/SigmaPlatform/Pipe,/turf/Nothing,/area)
"o" = (/obj/Autojoin/BackgroundGrassCliff,/obj/Decorative/Grass,/obj/Decorative/Mushroom,/turf/Nothing,/area)
"p" = (/obj/Brick/Cracked/Stone,/turf/Nothing,/area)
"q" = (/obj/Decorative/Grass,/obj/Brick/Cracked/Stone,/turf/Nothing,/area)
"r" = (/obj/WoodBlock,/turf/Nothing,/area)
"s" = (/obj/PlayerStart,/turf/Nothing,/area)
"t" = (/obj/Autojoin/SigmaPlatform,/turf/Nothing,/area)
"u" = (/obj/Autojoin/SigmaPlatform,/obj/Decorative/Sigma1/Vent,/turf/Nothing,/area)
"v" = (/obj/Autojoin/GrassCliff,/obj/Autojoin/SigmaPlatform,/turf/Nothing,/area)
"w" = (/obj/Decorative/Grass,/obj/Autojoin/SigmaPlatform/Pipe,/turf/Nothing,/area)
"x" = (/obj/OneWayBlock{tag = "icon-OneWay"; icon_state = "OneWay"; dir = 2},/turf/Nothing,/area)
"y" = (/obj/Autojoin/BackgroundGrassCliff,/obj/Collectible/Emerald,/turf/Nothing,/area)
"z" = (/obj/Autojoin/GrassCliff,/obj/Autojoin/SigmaPlatform,/obj/Decorative/Sigma1/Vent,/turf/Nothing,/area)
"A" = (/obj/Autojoin/GrassCliff,/obj/Autojoin/SigmaPlatform,/obj/Autojoin/SigmaPlatform/Pipe,/turf/Nothing,/area)
"B" = (/obj/Autojoin/GrassCliff,/obj/Autojoin/SigmaPlatform,/obj/Decorative/Sigma1/Tech,/turf/Nothing,/area)
"C" = (/obj/Autojoin/GrassCliff,/obj/Autojoin/SigmaPlatform,/obj/Autojoin/SigmaPlatform/Pipe{dir = 4},/turf/Nothing,/area)
"D" = (/obj/Autojoin/GrassCliff,/obj/Autojoin/SigmaPlatform/Pipe{dir = 4},/turf/Nothing,/area)
"E" = (/mob/IronCrate,/turf/Nothing,/area)
"F" = (/obj/Autojoin/SigmaPlatform/Pipe{dir = 4},/turf/Nothing,/area)
"G" = (/obj/Autojoin/BackgroundGrassCliff,/obj/Decorative/Grass,/mob/PlatformWalker,/turf/Nothing,/area)
"H" = (/obj/Collectible/Emerald,/obj/Autojoin/BackgroundGrassCliff,/turf/Nothing,/area)
"I" = (/obj/Autojoin/BackgroundGrassCliff,/obj/Decorative/Mushroom,/obj/Autojoin/SigmaPlatform/Pipe,/turf/Nothing,/area)
"J" = (/obj/Autojoin/BackgroundGrassCliff,/obj/Decorative/Mushroom/Small,/turf/Nothing,/area)
"K" = (/obj/Autojoin/BackgroundGrassCliff,/obj/Decorative/Mushroom,/turf/Nothing,/area)
"L" = (/obj/Water/Surface,/turf/Nothing,/area)
"M" = (/obj/Water,/turf/Nothing,/area)
"N" = (/obj/Hazard/Spikes,/turf/Nothing,/area)
"O" = (/obj/Autojoin/BackgroundGrassCliff,/obj/Water,/turf/Nothing,/area)
"P" = (/obj/Water,/mob/IronCrate,/turf/Nothing,/area)
"Q" = (/obj/Autojoin/BackgroundGrassCliff,/obj/Water,/mob/IronCrate,/turf/Nothing,/area)
"R" = (/obj/Decorative/Grass,/mob/PlatformWalker,/turf/Nothing,/area)
"S" = (/obj/Platform,/turf/Nothing,/area)
"T" = (/obj/Decorative/Grass,/mob/Squishy,/turf/Nothing,/area)
"U" = (/obj/Decorative/Flower,/obj/Decorative/Grass,/turf/Nothing,/area)
"V" = (/obj/Water,/obj/Water/Surface,/turf/Nothing,/area)
"W" = (/obj/Water,/obj/Brick/Cracked/Stone,/turf/Nothing,/area)
"X" = (/obj/Autojoin/SigmaPlatform,/obj/Decorative/Sigma1/Tech,/turf/Nothing,/area)

(1,1,1) = {"
aaaaaaaaaaaaaaaaaaaaaaaaaaaaaaaaaaaaaabbbbbbcbcbcbbaaaaaaaaaaaaaaaaabb
aaaaaaaaaaaaaaaaaaaaaaaaaaaaaaaaaaaaaaaaabddedededdfffaaaaaaagaaaaaabb
baaaaaaaaaaaaaaaaaaaaaaaaaaaaaaaaaaaaaaaaaffhfhfhfffffaaagaaaaaaagaabb
baaaaaaaaaaaaaaaaaiaaaaaaaaaaaaaaaaaaaaaaaffhfhfhfffffaaaaaaaaaaaaaabb
baaaaaaaaaaaaaaaaaiaaaaaggaaaaaaaaaaaaaaaaffhfffhffffffaaaaaaaaaaaajbb
baaaaaaaaaaaaaaaaaiaaaaaaaaaaaaaaaaaaaajkllmnlmonlllmlljkjjjpppjjkjbbb
baaaaaaaaaaaaaaaaaiaaaaaaaaaaajjjjjqjjjbbdddedddeddddddbbbbbbbbbbbbbbb
baaaaaaaaaaagaaaaaiagaaarraaaabbbbbbbbbbbbbbcbbbcbbbbbbbbbbbbbbbbbbbbb
bbgaaaaaaaaaaaaaaaiaaaaaaaaaaabbbbbbbbbbbbbbcbbbbbbbbbbbbbbbbbbbbbbbbb
bbaaaasaaaaaaaaaaaiaraaaaaaaaabbbbbbbbbbbbbbbbbbbbbbbbbbbbbbbbbbbbbbbb
bbjjjtutjjjkjqjjaaiaaagagaaaaabbbbbbbbbbbbbbbbbbbbbbbbbbbbbbbbbbbbbbbb
bbbbbvvvbbbbbbbbjjiaaaaaaaajqjbbbbbbbbbbbbbbbbbbbbbbbbbbbbbbbbbbbbbbbb
bbbbbbbbbbbbbbbbbbwjkjjjagabbbbbbbbbbbbbbbbbbbbbbbbbbbbbbbbbbbbbbbbbbb
bbbbbcbbbbbbbbbbbbcbbbbbxxxbbbbbbbbbbbbbbbbbbbbbbbbbbbbbbbbbbbbbbbbbbb
bbbbbcbbbbvvvvvvvbcbbbddfyfddbbbbbbbbbbbbbbbbbbbbbbbbbbbbbbbbbbbbbbbbb
bbbbbcbbbbvzABCzvbcbbbddfffddbbbbbbbbbbbbbbbbbbbbbbbbbbbbbbbbbbbbbbbbb
bbbbbcbbbbvzABCzvbcbbbddfyfddbbbbbbbbbbbbbbbbbbbbbbbbbbbbbbbbbbbbbbbbb
bbbbbcbbbbvvvvvvvbbbbbddfffddbbbbbbbbbbbbbbbbbbbbbbbbbbbbbbbbbbbbbbbbb
bbbbbcbbbbbbbbbbbbbbbbdffyffdbbbbbbbbbbbbbbbbbbbbbbbbDbbbbbbbbbbbbbbbb
bbbbbbbbbbbbbbbbbbbbbbdfffffdbEbbbbbbbbbbbbbbbbbbbbbbDbbbbbbbbbbbbbbbb
bbbbbbbbbbbbbbbbbbbbbbdffyffdbEbbbbbbbbbbbbbbbbbbbbbbDbbbbbbbbbbbbbbbb
bbbbbbbbbbbbbbbbbbbddddfffffdddbbbbbbbbbbbbbbbbbbbbaaFaaaaaaaaaaaaaaaa
bbbbbbbbbbbbbbbbbEEdddfffyfffddbbbbbbbbbbbbbbbbbbbbaaFaaaaaaaaaaaaaaaa
bbbbbbbbbbbbbbbbbEbddffffffffddbbbbbbbbbbbbbaaaaaaaaaFaaaaaaaaaaaaaaaa
bbbbbbbbbbbbbbbbbEbdfffffyfffddbbbbbbbbbbbbbaaaaaaaaaFaaaaaaaaaaaaaaaa
bbbbbbbbbbbbbbbbbbbdffffffffffdbbbbbbbbbbaaaaaaEaaaaaFaaaaaaaaaaaaaaaa
bbbbbbbbbbbbbbbbbbbdffffffffffdbbbbbcbbcbaaaaaabaaaaaFaaaaaaaaaaaaaaaa
bbbbbbbbbbbbbbbbcbddffffffffffddddddeddebaaaaaabaaaaaFaaaaaaaaaaaaaaaa
bbbdddddbbdddbbbedddfaaafffaaabdffffhyfhaaaaaaabaaaaaFaaaaaaaaaaaaaaaa
aaafffffaaffaaaahffffaaafffaaaaaafylnGlnjjjjkjjbaaaaaFaaaaaaaaaaaaaaaa
aaaffaffaaffaaaahfffaaaafHaaaaagaafdeddebbbbbbbcaaaaaFaaaaaaaaaaaaaaaa
aaaffaffaafaaaaahfffaaaaafaaaaaaaaabcbbcbbbbbaaiaaaaaFaaaaaaaaaaaaaaaa
aaaffaafaafaaaaahfyfaaagafagaaaaaabbbbbbbaaaaaaiaaaaaFaaaaaaaaaaaaaaaa
aaafaaaaaafaaaaaIJKJjaaaaaaaaaaaabbbbbbbbaaaaaaiaaaaaFaaaaaaaaaaaaaaaa
aaafaaaaaafagaaaedddbLLLLLLLLLLLLbbbbbbbaaaaaaaiaaaaaFaaaaaaaaaaaaaaaa
aaaaaaaaaaaaaaabcbbbbMMMMMMMMMMMMbbbbbbaaaaaaaaiaaaaaFaaaaaaaaaaaaaaaa
aaaaaaaagaaaaNNbbbbbbbMMMMMMMMMMOddddbaaaaaaaabcbbbbbDpaaaaaaaaaaaaaaa
aaaaaaaaaaaaabbbbbbbbbMPMMMMMMMMOOQOOMaaaaaaaabbbbbbbDbbbaaaaaaaaaaaaa
aaaaaaaaaabbbbbbbbbbbbbbbbbbbbbbdddddMaaaaaaaabaaaabbDbbbaaaaaaaaaaaaa
aaaaaaaaaacbbbbbbbbbbbbbbbbbbbbbbbbdbMaaaaaraaaaaaaabbbbbaaaaaaaaaaaaa
aaaaaaaaaaibbbbbbbbbbbbbbbbbbbbbdbbdaMaaaaaaaaaaaaaabbbbbaaaaaaaaaaaaa
aaaaaagaaaiaaaabbdddddbbbbbbbdbbfaafaMaaaaaaaaaaaaaaaabbbaaaaaaaaaaaaa
aaajRqjaagiaaaaaaafffaabdbbbafaafaaaaMaaarSSraaaaaaaaabbbaaaaaaaaaaaaa
aaabbbbjjkwjaaaaaafHaaagfaaaafaafaaaaMaaaaaaaaaaaaaraaabbaaaaaaaaaaaaa
aaabbbbbbbcbjkaaagaaagaafgaaaaaaaaaaaMaaaaaaaaaaaaaaaaabaaaaaaaaaaaaaa
aaababbbbbbbbbaaaaaaaaaaaaaaaaaTUaaaaMaaaajjaaaaaaaaaaabaaaaaaaaaaaaaa
aaaaabbbbbbbbbSSSSSSSSSSSSSSSSSbbLLLLVLLLLbbaaarSSSSSraaaaaaaaaaaaaaaa
aaaaaaaaaaaaaaaaaaaaaaaaaaaaaaabbbMMMMMMMMbbaaaaaaaaaaaaaaaaaaaaaaaaaa
aaaaaaaaaaaaaaaaaaaaaaaaaaaaaaabbbMMMMMWWMbbaaaaaaaaaaaaaaaaaaaaaaaaaa
aaaaaaaaaaaaaaaaaaaaaaaaaaaaaaabbbbbbbbbbbbbaaaaaaaaaaaaaaaaaaaaaaaaaa
aaaaaaaaaaaaaaaaaaaaaaaaaaaaaaabbbbbbbbbcbbbaaaaaaaaaaaaaaaaaaaaaaaaaa
aaaaaaaaaaaaaaaaaaaaaaaaaaaaaaaaaaaaaaaaiaaaaaaaaaaaaaaaaaaaaaaaaaaaaa
aaaaaaaaaaaaaaaaaaaaaaaaaaaaaaaaaaaaaaaaiaaaaaaaaaaaaaaaaaaaaaaaaaaaaa
aaaaaaaaaaaaaaaaaaaaaaaaaaaaaaaaaaaaaaaaiaaaaaaaaaaaaaaaaaaaaaaaaaaaaa
aaaaaaaaaaaaaaaaaaaaaNNaaaaaaaaaaaaaaaaaiaaaaaaaaaaaaaaaaaaaaaaaaaaaaa
aaaaaaaaaaaaaaaaaaaaabbaaaaaaaaaaaaaaaaaiaaaaaaaaaaaaaaaaaaaaaaaaaaaaa
aaaaaaaaaaaaaaaaaaNaabbaaaaaaaaaaaaaaaaaiaaaaaaaaaaaaaaaaaaaaaaaaaaaaa
aaaaaaaaaaaaaaaNNNbaabbaaaaaaaaaaaaaaaaNiaaaaaaaaaaaaaaaaaaaaaaaaaaaaa
aaaaaaaaaaaaaaabbbbaNbbNaaaaaaaaaaaaaaabcbaaaaaaaaaaaaaaaaaaaaaaaaaaaa
aaaaaaaaaaaaaaabbbbNbbbbaaaNaaaaaNaaaaabcbaaaaaaaaaaaaaaaaaaaaaaaaaaaa
aaaaaaaaaaaaaaabddbbddddNNabaaaaNbNaaaNbbbaaaaaaaaaaaaaaaaaaaaaaaaaaaa
aaaaaaaaaaaaaaabddbddffdbbNbNaaNbbbNaabddbaaaaaaaaaaaaaaaaaaaaaaaaaaaa
aaaaaaaaaaaaaaaaddddfffdddddbaabbddbaNbdfaaaaaaaaaaaaaaaaaaaaaaaaaaaaa
aaaaaaaaaaaaaaaafffffffffdddbaaaafdbNbbdfaaaaaaaaaaaaaaaaaaaaaaaaaaaaa
aaaaaaaaaaaaaaaaffffffffffffaaaaaffddddffaaaaaaaaaaaaaaaaaaaaaaaaaaaaa
aaaaaaaaaaaaaaaaffffffffffffaaaaaffffffffabbaaaaaaaaaaaaaaaaaaaaaaaaaa
aaaaaaaaaaaaaaabddfffffdddddbaaabdddffffffdbaaaaaaaaaaaaaaaaaaaaaaaaaa
aaaatttttttNttabddddddddddddaaaaabbddddddddbaaaaaaaaaaaaaaaaaaaaaaaaaa
aaaatXuXuXtattNbbbbbbbbbbaaaaaaaaabbbbbbbbbaaaaaaaaaaaaaaaaaaaaaaaaaaa
ttaatttttttattaabbbbaaaaaaaaaaaaaaaaaaaaaaaaaaaaaaaaaaaaaaaaaaaaaaaaaa
ttaaaaaaaaaaaaaaaaaaaaaaaaaaaaaaaaaaaaaaaaaaaaaaaaaaaaaaaaaaaaaaaaaaaa
ttaaaaaaaaaaaaaaaaaaaaaaaaaaaaaaaaaaaaaaaaaaaaaaaaaaaaaaaaaaaaaaaaaaaa
ttattaaaaaaaaaaaaaaaaaaaaaaaaaaaaaaaaaaaaaaaaaaaaaaaaaaaaaaaaaaaaaaaaa
aaattaaaaaaaaaaaaaaaaaaaaaaaaaaaaaaaaaaaaaaaaaaaaaaaaaaaaaaaaaaaaaaaaa
aaaaaaaaaaaaaaaaaaaaaaaaaaaaaaaaaaaaaaaaaaaaaaaaaaaaaaaaaaaaaaaaaaaaaa
aaaaaaaaaaaaaaaaaaaaaaaaaaaaaaaaaaaaaaaaaaaaaaaaaaaaaaaaaaaaaaaaaaaaaa
aaaatttttaaaaattttttaaaaaaaaaaaaaaaaaaaaaaaaaaaaaaaaaaaaaaaaaaaaaaaaaa
aaaatttttaaaaattttttaaaaaaaaaaaaaaaaaaaaaaaaaaaaaaaaaaaaaaaaaaaaaaaaaa
aaaaaaaaaaaaaaaaaaaaaaaaaaaaaaaaaaaaaaaaaaaaaaaaaaaaaaaaaaaaaaaaaaaaaa
aaaaaaaaaaaaaaaaaaaaaaaaaaaaaaaaaaaaaaaaaaaaaaaaaaaaaaaaaaaaaaaaaaaaaa
aaaaaaaaaaaaaaaaaaaaaaaaaaaaaaaaaaaaaaaaaaaaaaaaaaaaaaaaaaaaaaaaaaaaaa
aaaaaaaaaaaaaaaaaaaaaaaaaaaaaaaaaaaaaaaaaaaaaaaaaaaaaaaaaaaaaaaaaaaaaa
aaaaaaaaaaaaaaaaaaaaaaaaaaaaaaaaaaaaaaaaaaaaaaaaaaaaaaaaaaaaaaaaaaaaaa
aaaaaaaaaaaaaaaaaaaaaaaaaaaaaaaaaaaaaaaaaaaaaaaaaaaaaaaaaaaaaaaaaaaaaa
aaaaaaaaaaaaaaaaaaaaaaaaaaaaaaaaaaaaaaaaaaaaaaaaaaaaaaaaaaaaaaaaaaaaaa
aaaaaaaaaaaaaaaaaaaaaaaaaaaaaaaaaaaaaaaaaaaaaaaaaaaaaaaaaaaaaaaaaaaaaa
aaaaaaaaaaaaaaaaaaaaaaaaaaaaaaaaaaaaaaaaaaaaaaaaaaaaaaaaaaaaaaaaaaaaaa
aaaaaaaaaaaaaaaaaaaaaaaaaaaaaaaaaaaaaaaaaaaaaaaaaaaaaaaaaaaaaaaaaaaaaa
aaaaaaaaaaaaaaaaaaaaaaaaaaaaaaaaaaaaaaaaaaaaaaaaaaaaaaaaaaaaaaaaaaaaaa
aaaaaaaaaaaaaaaaaaaaaaaaaaaaaaaaaaaaaaaaaaaaaaaaaaaaaaaaaaaaaaaaaaaaaa
aaaaaaaaaaaaaaaaaaaaaaaaaaaaaaaaaaaaaaaaaaaaaaaaaaaaaaaaaaaaaaaaaaaaaa
aaaaaaaaaaaaaaaaaaaaaaaaaaaaaaaaaaaaaaaaaaaaaaaaaaaaaaaaaaaaaaaaaaaaaa
aaaaaaaaaaaaaaaaaaaaaaaaaaaaaaaaaaaaaaaaaaaaaaaaaaaaaaaaaaaaaaaaaaaaaa
aaaaaaaaaaaaaaaaaaaaaaaaaaaaaaaaaaaaaaaaaaaaaaaaaaaaaaaaaaaaaaaaaaaaaa
aaaaaaaaaaaaaaaaaaaaaaaaaaaaaaaaaaaaaaaaaaaaaaaaaaaaaaaaaaaaaaaaaaaaaa
aaaaaaaaaaaaaaaaaaaaaaaaaaaaaaaaaaaaaaaaaaaaaaaaaaaaaaaaaaaaaaaaaaaaaa
aaaaaaaaaaaaaaaaaaaaaaaaaaaaaaaaaaaaaaaaaaaaaaaaaaaaaaaaaaaaaaaaaaaaaa
aaaaaaaaaaaaaaaaaaaaaaaaaaaaaaaaaaaaaaaaaaaaaaaaaaaaaaaaaaaaaaaaaaaaaa
aaaaaaaaaaaaaaaaaaaaaaaaaaaaaaaaaaaaaaaaaaaaaaaaaaaaaaaaaaaaaaaaaaaaaa
aaaaaaaaaaaaaaaaaaaaaaaaaaaaaaaaaaaaaaaaaaaaaaaaaaaaaaaaaaaaaaaaaaaaaa
aaaaaaaaaaaaaaaaaaaaaaaaaaaaaaaaaaaaaaaaaaaaaaaaaaaaaaaaaaaaaaaaaaaaaa
aaaaaaaaaaaaaaaaaaaaaaaaaaaaaaaaaaaaaaaaaaaaaaaaaaaaaaaaaaaaaaaaaaaaaa
aaaaaaaaaaaaaaaaaaaaaaaaaaaaaaaaaaaaaaaaaaaaaaaaaaaaaaaaaaaaaaaaaaaaaa
aaaaaaaaaaaaaaaaaaaaaaaaaaaaaaaaaaaaaaaaaaaaaaaaaaaaaaaaaaaaaaaaaaaaaa
aaaaaaaaaaaaaaaaaaaaaaaaaaaaaaaaaaaaaaaaaaaaaaaaaaaaaaaaaaaaaaaaaaaaaa
aaaaaaaaaaaaaaaaaaaaaaaaaaaaaaaaaaaaaaaaaaaaaaaaaaaaaaaaaaaaaaaaaaaaaa
aaaaaaaaaaaaaaaaaaaaaaaaaaaaaaaaaaaaaaaaaaaaaaaaaaaaaaaaaaaaaaaaaaaaaa
aaaaaaaaaaaaaaaaaaaaaaaaaaaaaaaaaaaaaaaaaaaaaaaaaaaaaaaaaaaaaaaaaaaaaa
aaaaaaaaaaaaaaaaaaaaaaaaaaaaaaaaaaaaaaaaaaaaaaaaaaaaaaaaaaaaaaaaaaaaaa
aaaaaaaaaaaaaaaaaaaaaaaaaaaaaaaaaaaaaaaaaaaaaaaaaaaaaaaaaaaaaaaaaaaaaa
aaaaaaaaaaaaaaaaaaaaaaaaaaaaaaaaaaaaaaaaaaaaaaaaaaaaaaaaaaaaaaaaaaaaaa
aaaaaaaaaaaaaaaaaaaaaaaaaaaaaaaaaaaaaaaaaaaaaaaaaaaaaaaaaaaaaaaaaaaaaa
aaaaaaaaaaaaaaaaaaaaaaaaaaaaaaaaaaaaaaaaaaaaaaaaaaaaaaaaaaaaaaaaaaaaaa
aaaaaaaaaaaaaaaaaaaaaaaaaaaaaaaaaaaaaaaaaaaaaaaaaaaaaaaaaaaaaaaaaaaaaa
aaaaaaaaaaaaaaaaaaaaaaaaaaaaaaaaaaaaaaaaaaaaaaaaaaaaaaaaaaaaaaaaaaaaaa
aaaaaaaaaaaaaaaaaaaaaaaaaaaaaaaaaaaaaaaaaaaaaaaaaaaaaaaaaaaaaaaaaaaaaa
aaaaaaaaaaaaaaaaaaaaaaaaaaaaaaaaaaaaaaaaaaaaaaaaaaaaaaaaaaaaaaaaaaaaaa
aaaaaaaaaaaaaaaaaaaaaaaaaaaaaaaaaaaaaaaaaaaaaaaaaaaaaaaaaaaaaaaaaaaaaa
aaaaaaaaaaaaaaaaaaaaaaaaaaaaaaaaaaaaaaaaaaaaaaaaaaaaaaaaaaaaaaaaaaaaaa
aaaaaaaaaaaaaaaaaaaaaaaaaaaaaaaaaaaaaaaaaaaaaaaaaaaaaaaaaaaaaaaaaaaaaa
"}
