"a" = (/turf/Autojoin/SigmaPlatform/Iron,/area)
"b" = (/turf/Nothing,/area)
"c" = (/obj/PlayerStart,/turf/Nothing,/area)
"d" = (/obj/Autojoin/SigmaPlatform/Iron/Midbar,/turf/Autojoin/SigmaPlatform/Iron,/area)
"e" = (/turf/Autojoin/SigmaPlatform,/area)
"f" = (/obj/Hazard/Lava,/turf/Nothing,/area)
"g" = (/obj/Hazard/Lava/Deep,/turf/Nothing,/area)
"h" = (/turf/Autojoin/SigmaPlatform/Iron/Fancy,/area)

(1,1,1) = {"
aaaaaaaabbbbaaaaaabbbbbbbbbbbbbbbbbbbbbbbbbbbbbbbb
aaaaaaaabbcbaaaaaabbbbbbbbbbbbbbbbbbbbbbbbbbbbbbbb
aabbbbbbbbbbbbbbaabbbbbbbbbbbbbbbbbbbbbbbbbbbbbbbb
aabbbbbbbbbbbbbbaabbbbbbbbbbbbbbbbbbbbbbbbbbbbbbbb
aabbbbbbbbbbbbbbddbbbbbbbbbbbbbbbbbbbbbbbbbbbbbbbb
aabbbeeeeeeeeebbaabbbbbbbbbbbbbbbbbbbbbbbbbbbbbbbb
aabbbeeeeeeeeebbaabbbbbbbbbbbbbbbbbbbbbbbbbbbbbbbb
aabbbbbbbbbbbbbbaabbbbbbbbbbbbbbbbbbbbbbbbbbbbbbbb
aabbbbbbbbbbbbbbddbbbbbbbbbbbbbbbbbbbbbbbbbbbbbbbb
aabbbbbbbbbbbbbbaabbbbbbbbbbbbbbbbbbbbbbbbbbbbbbbb
aaaaaaabbbbbaaaaaaaabbbbbbbbbbbbbbbbbbbbbbbbbbbbbb
aaaaaaabbbbbddddddddbbbbbbbbbbbbbbbbbbbbbbbbbbbbbb
aabbbbbbbbbbaaaaaaaabbbbbbbbbbbbbbbbbbbbbbbbbbbbbb
aabbbbbbbbbbbbbbbbbbbbbbbbbbbbbbbbbbbbbbbbbbaaaaaa
aabbbbbbbbbbbbbbbbbbbbbbbbbbbbbbbbbbbbbbbbbbaaaaaa
aabbbbbbbbbbbbbbbbbbbbbbbbbbbbbbbbbbbbbbbbbbaabbbb
aabbbbbbbbbbbbbbbbbbbbbbbbbbbbbbbbbbbbbbbbbbaaffff
aabbbbbbbbbbbbbbbbbbbbbbbbbbbbbbbbbbbbbbbbbbaagggg
aabbbbbbbbbbbbbbbbbbbbbbbbbbbbbbbbbbbbbbbbbbaagggg
aabbbbbbbbbbbbbbbbbbbbbbbbbbbbbbbbbbbbbbbbbbaagggg
aabbeeeeeeeeeeebbbbbbbbbbbbbeeebbbbbbbbbbbbbaagggg
aaffeeeeeeeeeeebbbbbbbbbbbbbeeebbbbbbbbbbbbbaagggg
aaggeeeeeeeeeeebbbeeeeeeebbbeeebeebbbbbbbbbbaagggg
aaggeeeeeeeeeeefffeeeeeeebbbeeebeebbbbbbbbbbaagggg
aaggeeeeeeeeeeegggeeeeeeefffeeefeebbbbbbbbbbaagggg
aaggeeeeeeeeeeegggeeeeeeegggeeegeebbbbbbbbbbaagggg
aaaaaaaaaaaaaaaaaaaaaaaaaaaaaaageebbbbbbbbbbaagggg
aaaaaaaaaaaaaaaaaaaaaaaaaaaaaaageebbbbbbbbbbaagggg
aaaaaaaaaaaaaaaaaaaaaaaaaaaaaaaaaaabbbaaaaaaaaaaaa
aaaaaaaaaaaaaaaaaaaaaaaaaaaaaaaaaaabbbaaaaaaaaaaaa
aaaaaaaaaaaaaaaaaaaaaaaaaaaaaaaaaaabbbaabbbbbbbbbb
aaaaaaaaaaaaaaaaaaaaabbbbbbbbbbbaaabbbaabbbbbbbbbb
aaaaaaaaaaaaaaaaaaaaabbbbbbbbbbbaaabbbaabbbbbbbbbb
aaaaaaaaaaaaaaaaaaaaabbbbbbbbbbbaaabbbaabbbbbbbbbb
aaaaaaaaaaaaaaaaaaaaabbbbbbbbbbbaaabbbaabbbbbbbbbb
aaaaaaaaaaaaaaaaaaaaabbbbbbbbbbbaaabbbaabbbbbbbbbb
aaaaaaaaaaaaaaaaaaaaabbbbbbbbbbbbbbbbbbbbbbbbbbbbb
aaaaaaaaaaaaaaaaaaaaabbbbbbbbbbbbbbbbbbbbbbbbbbbhh
aaaaaaaaaaaaaaaaaaaaabbbbbbbbbbbbbbbbbbbbbbbbhhbhh
aaaaaaaaaaaaaaaaaaaaabbbbbbbbbbbbbbbbbbbbbbbbhhbhh
aaaaaaaaaaaaaaaaaaaaabbbbbbbhhhhhhhhhhhhhhhhfhhfhh
aaaaaaaaaaaaaaaaaaaaabbbbhhbhhhhhhhhhhhhhhhhghhghh
aaaaaaaaaaaaaaaaaaaaabbbbhhbhhhhhhhhhhhhhhhhghhghh
aaaaaaaaaaaaaaaaaaaaabbbbhhbbbbhhhggggggggggghhghh
aaaaaaaaaaaaaaaaaaaaabbbbhhhhhbhhhgggggggggggggghh
aaaaaaaaaaaaaaaaaaaaabbbbhhhhhbhhhgggggggggggggggg
aaaaaaaaaaaaaaaaaaaaabbbbbbbbbbhhhgggggggggggggggg
aaaaaaaaaaaaaaaaaaaaahhhhhhhhhhhhhhhhhgggggggggggg
aaaaaaaaaaaaaaaaaaaaahhhhhhhhhhhhhhhhhgggggggggggg
aaaaaaaaaaaaaaaaaaaaahhhhhhhhhhhhhhhhhgggggggggggg
"}
